Channel,Creative Size,Clicks,Total Conversions,Post-Click Conversions,Post-View Conversions
/All Apps/Apple App Store/Book,728x90,45,0,0,0
/All Apps/Apple App Store/Games/Puzzle,970x250,8,1,1,0
/All Apps/Google Play/Games/Arcade,300x600,104,23,22,1
Western Black sx,160x600,8,687,0,687
mogo marks cincinnati sx,320x50,26,60,10,50
mogo marks playbill sx x3e,300x250,139,589,59,530
/All Apps/Google Play/Games,160x600,9,3,2,1
University of Colorado--Shortlist- HighCTR/ high CPA ,728x90,0,4,0,4
mogo marks branding drhbx silver sx,468x60,1,1,0,1
mogo marks branding tier 1 sx xls37852,320x100,95,184,47,137
sfoc marks lal custom sx,300x250,1,3,0,3
mogo marks classical music sx,728x90,2,13,0,13
mogo marks native medium reach tail aggregate sx,468x60,0,1,0,1
CST KPI List,300x250,23,28,6,22
DO NOT USE Tier 1,Unknown,575,35,0,35
DO NOT USE Tier 1,468x60,0,1,0,1
mogo marks chicago sx,320x50,220,191,86,105
mogo marks xsl_ks0001 sx,320x100,116,206,45,161
mogo sports sx,320x100,2,9,0,9
ttd health sx,970x250,26,49,17,32
/All Apps/Apple App Store/Entertainment,970x250,11,1,1,0
Channel of Top Global Sites for Nielsen Display Ads - DO NOT EDIT,300x600,5701,22947,1944,21003
mogo canada t1 sx,336x280,0,2,0,2
mogo cult soph sx,336x280,0,5,0,5
mogo marks branding comp rate platinum video sx,970x250,1059,1682,304,1378
mogo marks detroit sx,300x250,151,424,69,355
/All Apps,320x100,1,0,0,0
mogo marks video sx xsl44760 class b,320x50,706,923,249,674
ttd entertainment sx,300x50,23,607,28,579
mogo marks lal (purchase) silver sx,200x200,0,2,0,2
mogo marks xsl_ks0001 sx,300x600,4026,14748,1353,13395
mogo marks xsl_ks20780 sx,970x90,26,32,1,31
mogo sports sx,300x600,78,191,29,162
pac esports sx,250x250,0,2,0,2
ttd education sx,300x250,552,2722,196,2526
zt local austin sx,728x90,1,10,2,8
/All Apps/Apple App Store/Music,320x50,258,1,1,0
/All Apps/Google Play/Entertainment,300x600,16,4,4,0
Duxiana- Bad Site List(Allan) ,320x50,76,7,0,7
Stratford Black RT SX,728x90,3,30,1,29
magic theatre top performing sx,970x250,16,25,10,15
mogo marks high intenders sx,728x90,92,689,39,650
mogo marks nyt sx,300x250,1042,1404,319,1085
ttd female sx,300x50,8,207,4,203
/All Apps/Apple App Store/Games/Action,728x90,10,1,1,0
mogo marks branding tier 1 sx xls37852,300x600,3976,16705,1438,15267
mogo marks shakespeare sx,320x50,5,8,2,6
mogo marks xsl_74205 sx ,320x100,12,31,8,23
sfoc marks kpi sx (062018),728x90,19,452,20,432
provident shortlist ,468x60,0,1,0,1
/All Apps/Google Play/Games,300x50,22,1,0,1
5a kpi sx,300x250,10,131,5,126
Stratford KPI revised,160x600,0,35,0,35
mogo marks disney sx,300x250,12,32,4,28
mogo marks nyt sx,320x50,0,1,0,1
mogo marks perf arts silver sx,320x100,0,4,0,4
mogo marks xsl_74205 (4p dims) sx ,300x50,11,317,16,301
sfoc pslx 2018 sx (Jun_2018),728x90,225,3245,177,3068
/All Apps/Apple App Store/Medical,320x50,67,0,0,0
APACTix Sitelist sx,300x600,12,13,1,12
Channel of Top non-US Sites for Nielsen Display Ads - DO NOT EDIT,120x600,1,0,0,0
mogo marks branding increased reach sx,160x600,5312,22742,1641,21101
mogo marks seattle sx,970x250,1,14,0,14
mogo marks branding drhbx gold sx,320x100,28,115,12,103
mogo marks jazz & blues sx,300x250,8,65,3,62
Performing Arts Fort Worth sx,300x250,3,17,0,17
ttd education sx,320x50,1323,1786,329,1457
ttd health wellness sx,160x600,60,308,7,301
Android Top Selling Free Music and Audio,300x50,3,0,0,0
Channel of Top Global Sites for Nielsen Display Ads - DO NOT EDIT,320x100,125,250,50,200
mogo marks branding max reach sx,160x600,5633,24406,1745,22661
mogo marks lal (purchase) gold sx,160x600,604,3784,200,3584
mogo marks native (sharethrough) unique can sx,300x600,630,1995,179,1816
sfjazz travel sx,300x600,7,24,4,20
sfoc cix sx,300x250,0,128,0,128
ttd health sx,320x100,4,4,1,3
/All Apps/Google Play/Games/Arcade,300x250,20,3,3,0
DO NOT USE Invite December Brand Safe List,970x90,10,11,1,10
DO NOT USE Spanish Language Sites,320x50,153,146,17,129
mogo marks branding comp rate platinum video sx,320x100,12,17,7,10
mogo marks kpi achievers sx,320x50,3332,4374,3077,1297
mogo marks native (sharethrough) unique us sx,970x90,1,4,0,4
mogo marks xsl_ks20780 sx,336x280,15,58,5,53
/All Apps/Apple App Store/Entertainment,320x100,1,0,0,0
/All Apps/Apple App Store/Games,970x250,28,1,1,0
Channel of Top US Sites for Nielsen Video Ads - DO NOT EDIT,970x250,1934,3636,644,2992
mogo marks branding drhbx gold sx,300x600,1141,6170,434,5736
mogo marks chicago sx,728x90,138,191,89,102
DO NOT USE Tier 1* (CHANNEL),300x600,3671,12822,1288,11534
/All Apps/Google Play/Social,300x50,50,0,0,0
Blacklist - Verification,300x250,0,1,0,1
mogo marks cincinnati sx,728x90,2,32,1,31
mogo marks perf arts sx 7,336x280,0,1,0,1
mogo marks video branding extended reach tail aggregate sx,468x60,1,1,0,1
/All Apps/Google Play/Education,728x90,1,0,0,0
/All Apps/Google Play/Entertainment,336x280,1,3,3,0
DO NOT USE AppNexus - Collective Media,320x50,10833,14048,5187,8861
Mogo DBM premium video sx,336x280,0,1,0,1
mogo biz-fi sx,320x50,219,521,90,431
mogo marks bwwpb sx,320x50,151,713,73,640
mogo marks native sx xsl1045 class a,160x600,16,182,3,179
mogo marks wsj sx x4v,300x250,22,75,8,67
mogo marks xsl_ks20780 sx,300x100,1,0,0,0
/All Apps/Apple App Store/Games/Casino,160x600,121,0,0,0
/All Apps/Apple App Store/Newsstand/Regional News,970x90,1,0,0,0
APACTix Sitelist sx,728x90,4,11,0,11
Diablo Blacklist ,300x600,0,13,0,13
finn dallas native sx,300x250,196,779,72,707
mogo CBS Interactive sx,300x250,89,439,38,401
mogo marks elite kpi achievers sx,300x250,1440,3599,479,3120
mogo marks perf arts sx 11,336x280,0,1,0,1
Channel of Top non-US Sites for Nielsen Display Ads - DO NOT EDIT,320x100,60,125,28,97
DO NOT USE Tier 2* (CHANNEL),300x600,488,2381,167,2214
Android Top Selling Free Health and Fitness,300x250,7,2,1,1
Android Top Selling Free Social,300x600,450,54,52,2
mogo financial services kpi sx,160x600,429,1467,172,1295
mogo marks broadway sx,320x50,171,894,82,812
mogo marks native (sharethrough) unique can sx,728x90,1003,6443,321,6122
mogo marks natl elite cat-aff-im sx,300x250,1535,4126,556,3570
mogo marks perf arts platinum sx,320x50,193,968,95,873
ttd weather sx,970x250,62,112,10,102
mogo marks native (sharethrough) unique us sx,250x250,2,1,0,1
mogo marks pav kpi sx 2,970x250,737,1917,369,1548
mogo marks perf arts sx 6,336x280,0,1,0,1
sfoc pslx 2019 sx (Mar_2019),970x250,71,397,61,336
ttd real estate sx,300x250,33,284,13,271
mogo marks outbound kpi sx x1a,300x250,1576,3978,543,3435
ttd beauty sx,728x90,4,37,1,36
mogo marks coupon sx,300x600,11,33,8,25
mogo perf arts sx,300x600,57,166,34,132
ttd family parent sx,320x100,4,3,1,2
DO NOT USE Tier 1,250x250,2,6,0,6
mogo marks lal branding (All) silver sx,300x600,2652,15091,1011,14080
mogo universal rt+ob black sx,300x250,6,15,4,11
ttd sports sx,160x600,48,128,4,124
mogo marks branding comp rate platinum video sx,970x90,4,2,0,2
/All Apps/Google Play/Games/Arcade,160x600,1,1,1,0
Android Top Selling Free Weather,300x600,517,263,246,17
mogo marks branding comp rate silver video sx,250x250,1,5,0,5
mogo marks branding drhbx silver sx,250x250,3,9,0,9
mogo marks native medium reach tail aggregate sx,250x250,4,7,0,7
mogo mba tier 2 sx,728x90,244,1613,75,1538
pac motorsports sx,970x90,1,0,0,0
DO NOT USE Invite December Brand Safe List,970x250,912,1150,240,910
dso custom hx,728x90,1,63,0,63
mogo centro sx US (2014),320x50,4345,4875,1539,3336
mogo marks playbill 5 sx x9z,970x250,9,44,5,39
ttd entertainment sx,728x90,1157,5253,422,4831
/All Apps/Google Play/Sports,320x50,320,23,16,7
Mogo DBM premium video sx,300x50,44,1519,29,1490
ttd finance sx,970x90,1,2,0,2
DO NOT USE Tier 3* (CHANNEL),728x90,2235,12499,865,11634
mogo lydia peacecenter test,300x250,6585,18790,1890,16900
mogo marks lal (purchase) platinum sx,300x600,593,2103,184,1919
/All Apps/Apple App Store/Book,300x50,1,2,0,2
/All Apps/Apple App Store/Games/Trivia,728x90,14,1,0,1
/All Apps/Apple App Store/Reference,320x50,261,5,3,2
DO NOT USE Mobile - MoPub - Health,320x50,5,1,1,0
DO NOT USE fgu test public channel,970x90,3,0,0,0
mogo marks native standard reach (no) tail aggregate sx,300x600,2764,11897,955,10942
ttd kids sx,970x250,17,60,3,57
tz - Local Seattle sx,728x90,2,12,0,12
/All Apps/Apple App Store/Newsstand/News & Politics,728x90,97,5,1,4
dbm video sx,970x90,4,6,0,6
mogo marks perf arts sx 11,300x50,0,2,0,2
ttd female sx,728x90,303,2768,137,2631
/All Apps/Google Play/Communication,300x250,1073,497,452,45
Stratford KPI sx,300x250,2,112,2,110
mogo marks branding tier 2 sx xls37852,970x90,16,17,1,16
mogo marks perf arts sx 11,320x50,160,768,76,692
mogo marks playbill sx x3e,300x600,0,1,0,1
mogo marks san francisco sx,300x250,156,617,82,535
mogo sf local sx,320x50,626,765,256,509
ttd weather sx,300x50,4,68,4,64
mogo marks branding elite tier sx xls37852,300x250,1422,3544,473,3071
mogo marks hq100p sx,970x90,8,9,0,9
mogo marks native high reach tail aggregate sx,300x250,11618,38975,3423,35552
mogo marks perf arts gold sx,300x250,335,1656,159,1497
mogo marks nyt sx,970x250,411,958,175,783
mogo marks ttd obx kitchen premium sink sx,728x90,5862,25161,1791,23370
mogo marks video sx xsl44760 class c,300x250,9436,30331,2880,27451
/All Apps/Google Play/Education,300x50,1,0,0,0
/All Apps/Google Play/Media & Video,320x50,31,4,4,0
Channel of Top Global Sites for Nielsen Video Ads - DO NOT EDIT,Unknown,575,35,0,35
mogo marks natl cat-aff-im sx,300x250,3821,10870,1267,9603
mogo marks perf arts platinum sx,300x600,27,85,20,65
mogo marks sacramento sx,160x600,0,1,0,1
mogo t1 brand sx,728x90,2305,6753,520,6233
mogo marks expedia sx,300x250,0,11,0,11
mogo marks native sx xsl1045 class b,300x600,395,1453,93,1360
mogo marks perf arts sx 6,320x50,175,919,83,836
mogo marks ttd obx kitchen premium sink sx,320x50,22889,33123,8985,24138
mogo marks xsl_800p sx,250x250,4,13,0,13
ttd education sx,970x250,78,79,6,73
Android Movers and Shakers,160x600,1,0,0,0
CST KPI List,320x50,1,1,1,0
Channel of Top Global Sites for Nielsen Video Ads - DO NOT EDIT,300x600,4603,16343,1640,14703
DO NOT USE AppNexus - Collective Media,970x250,456,737,158,579
Mogo DBM basic video sx,300x600,68,190,14,176
mogo marks t1 brand sx trim,300x250,6175,17131,1875,15256
mogo marks xsl_800p sx,160x600,3403,16151,1079,15072
/All Apps/Google Play/Games/Sports,300x600,6,0,0,0
mogo biz-fi sx,970x250,644,1399,285,1114
mogo marks branding comp rate gold video sx,336x280,0,1,0,1
mogo marks broadway sx,728x90,90,396,30,366
mogo marks native (sharethrough) unique can sx,320x100,10,19,2,17
mogo marks perf arts platinum sx,728x90,63,342,25,317
mogo marks stratford (canada) sx,970x250,0,34,0,34
Channel of Top US Sites for Nielsen Display Ads - DO NOT EDIT,200x200,0,3,0,3
mogo marks bwwpb sx,970x250,24,130,52,78
mogo marks detroit sx,320x50,407,417,226,191
mogo marks trip advisor sx,300x250,9,328,6,322
DO NOT USE Invite December Brand Safe List,250x250,2,11,0,11
mogo marks branding max reach sx,120x600,1,0,0,0
mogo marks native sx xsl1045 class b,728x90,1095,3069,131,2938
mogo marks native sx xsl1045 class c,468x60,0,1,0,1
mogo marks playbill sx x3e,728x90,16,102,10,92
/All Apps/Apple App Store/Games/Board,300x50,14,0,0,0
/All Apps/Google Play,160x600,10,3,2,1
DO NOT USE Tier 2,336x280,1,7,0,7
provident shortlist ,970x250,1327,2980,498,2482
sfoc kpi sx (acquisition 2019),160x600,0,35,0,35
ttd auto sx,300x600,28,94,7,87
ttd gaming sx,970x90,1,0,0,0
/All Apps/Google Play/Tools,300x600,59,16,16,0
Mogo DBM select video sx,320x50,229,400,56,344
Portland Center Stage KPI sx,320x50,5,10,0,10
mogo marks xsl66781 sx,728x90,553,3662,264,3398
/All Apps/Apple App Store,300x600,4407,618,573,45
/All Apps/Apple App Store/Newsstand/News & Politics,970x90,1,0,0,0
/All Apps/Google Play/Games/Card,300x600,50,8,7,1
/All Apps/Google Play/Games/Trivia,300x250,7,0,0,0
APACTix Sitelist sx,160x600,1,1,0,1
Pac Private Events/Wedding sx,200x200,0,1,0,1
mogo marks branding tier 2 sx xls37852,728x90,2908,20070,1063,19007
mogo mba tier 1 sx,300x600,85,650,33,617
/All Apps/Google Play/Productivity,728x90,6,0,0,0
DO NOT USE Tier 2* (CHANNEL),250x250,0,5,0,5
DO NOT USE Tier 3* (CHANNEL),970x90,15,11,0,11
mogo marks lal branding (All) gold sx,320x50,7860,13986,4390,9596
mogo marks native (sharethrough) unique can sx,160x600,113,341,24,317
ttd gaming sx,300x600,311,474,132,342
Channel of Top Global Sites for Nielsen Display Ads - DO NOT EDIT,300x50,270,8222,190,8032
Performing Arts Fort Worth Perf Arts 5 black sx,728x90,0,2,0,2
mogo marks hq100p sx,728x90,2590,10041,611,9430
sfoc 2018 marks stratford premium sx,320x50,639,3362,394,2968
mogo marks branding increased reach sx,300x250,18668,67724,5546,62178
mogo marks video branding medium reach tail aggregate sx,300x100,1,0,0,0
sfoc rtx kpi sx,300x250,61,631,56,575
ttd family parent sx,320x50,277,774,96,678
ttd spanish sx,970x250,2,0,0,0
Android Top Selling Free Weather,300x250,91,33,27,6
BBB perf arts 5 black sx,160x600,0,6,0,6
DO NOT USE Mobile - MoPub - Computers & Electronics/Software/Multimedia Software/Audio & Music Software,320x50,60,0,0,0
mogo marks branding tier 1 sx xls37852,300x50,139,4658,112,4546
mogo marks email sx,300x600,53,153,14,139
mogo marks native (sharethrough) unique us sx,970x250,200,330,42,288
mogo marks perf arts silver sx,160x600,78,620,31,589
mogo marks playbill 5 sx x9z,320x50,149,694,73,621
mogo marks video branding extended reach tail aggregate sx,250x250,5,8,0,8
sfoc stratford hqcat sx,970x250,8,103,4,99
ttd education sx,300x50,26,916,27,889
Android Top Selling Free Game,336x280,2,0,0,0
Greg's GG KPI + relevant sites list,728x90,6,15,2,13
/All Apps/Apple App Store/Medical,300x50,1,0,0,0
DO NOT USE Tier 2,300x600,488,2381,167,2214
Greg's GG KPI + relevant sites list,320x50,2,17,1,16
mogo marks lal branding (All) silver sx,300x250,7003,34691,2402,32289
mogo perf arts sx,300x250,1438,3025,489,2536
Duxiana- Bad Site List(Allan) ,970x250,32,0,0,0
mogo marks coupon sx,300x250,7,86,6,80
/All Apps/Apple App Store/Games/Adventure,320x50,5,0,0,0
/All Apps/Google Play/Games/Action,300x600,170,96,86,10
mogo marks branding comp rate gold video sx,300x600,1960,4909,690,4219
sfoc hqcat black hx,300x250,9,167,13,154
/All Apps/Apple App Store/Travel,300x250,88,1,1,0
Android Top Selling Free Entertainment,300x250,52,11,9,2
Channel of Top non-US Sites for Nielsen Display Ads - DO NOT EDIT,300x600,3644,16686,1212,15474
mogo marks branding drhbx gold sx,728x90,902,5535,331,5204
mogo marks seattle sx,320x50,32,45,4,41
mogo marks sports sx,970x250,70,153,20,133
/All Apps/Google Play/Games/Puzzle,300x250,20,4,4,0
Android Top Selling Free Tools,300x600,89,27,25,2
DO NOT USE Tier 1* (CHANNEL),728x90,4726,15686,1192,14494
/All Apps/Google Play/Games/Simulation,320x50,17,0,0,0
mogo marks branding drhbx platinum sx,300x250,1456,3479,461,3018
mogo marks nyc sx,336x280,0,1,0,1
mogo marks video branding extended reach tail aggregate sx,300x250,11841,37573,3482,34091
pac esports sx,300x50,10,335,15,320
/All Apps/Apple App Store/Games/Sports,320x50,7,0,0,0
mogo lydia peacecenter test,300x600,1353,4390,516,3874
mogo marks outbound kpi sx x1a,300x50,0,20,0,20
/All Apps/Apple App Store/Games/Simulation,300x600,2,0,0,0
Android Top Selling Free Sports,300x50,2,0,0,0
DO NOT USE Tier 3* (CHANNEL),300x50,82,2820,87,2733
University of Colorado--Shortlist- HighCTR/ high CPA ,300x600,0,3,0,3
mogo centro sx US (2014),300x50,13,290,20,270
mogo marks wine sx,320x100,1,0,0,0
mogo marks xsl_74205 (2p dims) sx ,250x250,0,2,0,2
/All Apps/Apple App Store/Music,728x90,25,0,0,0
/All Apps/Google Play/Entertainment,300x250,15,0,0,0
Mogo dating sx,160x600,0,1,0,1
finn dallas native sx,970x250,15,54,10,44
mogo marks elite kpi achievers sx,320x50,376,948,129,819
mogo sports sx,300x250,474,1436,109,1327
ttd health sx,300x600,54,330,10,320
/All Apps/Apple App Store/Games/Puzzle,300x600,678,123,109,14
DCPA rt black sx,728x90,4,23,1,22
mogo marks video sx xsl44760 class b,728x90,1217,2060,237,1823
/All Apps/Apple App Store/Entertainment,300x600,3841,583,545,38
/All Apps/Google Play/Games/Role Playing,300x250,2,0,0,0
Android Top Selling Free Education,300x600,7,7,5,2
Arizona Theatre Company - Site List,300x600,1,2,0,2
Channel of Top US Sites for Nielsen Display Ads - DO NOT EDIT,300x100,1,0,0,0
Arvada local sx,300x600,0,10,0,10
mogo marks branding tier 1 sx xls37852,300x250,13702,47284,4205,43079
mogo marks lal branding (All) gold sx,160x600,662,4176,212,3964
/All Apps/Apple App Store/Weather,300x250,12,0,0,0
Channel of Top Global Sites for Nielsen Display Ads - DO NOT EDIT,336x280,29,43,4,39
mogo marks lal (purchase) gold sx,970x250,781,2015,345,1670
DO NOT USE AppNexus - Collective Media,970x90,3,2,0,2
DO NOT USE Tier 1,320x50,14384,18622,6107,12515
Diablo DVC Shortlist (Advertiser Level),300x600,26,3668,76,3592
mogo marks branding max reach sx,320x100,158,336,61,275
mogo marks perf arts branding high reach sx,728x90,110,761,38,723
mogo marks sacramento sx,728x90,31,226,14,212
mogo marks xsl_800p sx,300x600,4507,19575,1605,17970
ttd health wellness sx,320x100,1,3,0,3
mogo marks pav kpi sx,160x600,65,486,25,461
mogo marks toronto sx,728x90,66,810,22,788
mogo marks video branding max reach tail aggregate sx,300x600,4969,17514,1763,15751
/All Apps/Google Play,300x600,1552,310,286,24
/All Apps/Google Play/Games/Arcade,336x280,1,4,4,0
/All Apps/Google Play/Lifestyle,300x50,1,0,0,0
sfoc kpi sx (acquisition 2019),300x600,85,777,97,680
/All Apps/Google Play/Photography,300x600,12,1,1,0
DO NOT USE Mobile - MoPub - Arts & Entertainment,728x90,31,1,1,0
BBB perf arts 5 black sx,300x250,0,6,0,6
DO NOT USE Mobile - MoPub - Arts & Entertainment,320x50,82,1,1,0
DO NOT USE fgu test public channel,320x50,29,43,3,40
mogo marks perf arts silver sx,300x250,386,1877,176,1701
/All Apps/Apple App Store/Games/Racing,320x50,1,0,0,0
dbm video sx,728x90,2015,11543,623,10920
mogo marks lal branding (All) gold sx,300x50,88,3569,63,3506
mogo marks native sx xsl1045 class c,728x90,1898,7636,422,7214
mogo marks natl cat-aff-im sx 2,336x280,0,2,0,2
Chicago T1 sites,160x600,4,7,2,5
DO NOT USE Tier 3* (CHANNEL) (2),728x90,284,2047,103,1944
ttd family parent sx,300x50,1,106,0,106
Channel of Top non-US Sites for Nielsen Video Ads - DO NOT EDIT,300x250,10784,31056,2877,28179
DCPA display local sx,320x50,9,35,0,35
mogo marks branding comp rate gold video sx,160x600,1260,3889,287,3602
mogo marks pav kpi sx,970x90,0,2,0,2
mogo marks perf arts sx 5 epx1,336x280,0,1,0,1
ttd finance sx,728x90,332,2012,151,1861
/All Apps/Apple App Store/Games,728x90,2813,255,240,15
Channel of Top US Sites for Nielsen Video Ads - DO NOT EDIT,728x90,7122,33479,2438,31041
DO NOT USE Mobile - MoPub - Games/Computer & Video Games/Music & Dance Games,300x250,81,3,3,0
mogo marks coupon sx,160x600,1,5,0,5
mogo marks sports sx,300x600,46,62,4,58
/All Apps/Google Play/Games/Word,320x50,192,51,31,20
mogo marks branding tier 2 sx xls37852,300x50,102,3930,81,3849
mogo marks pav kpi hx,320x100,12,17,7,10
/All Apps/Google Play/Games/Word,728x90,32,3,3,0
DO NOT USE Tier 2,160x600,203,876,48,828
DO NOT USE Tier 3* (CHANNEL) (2),320x50,757,995,234,761
Mogo DBM select video sx,300x50,4,84,1,83
RCU Blacklist Sites (CPA),728x90,0,2,0,2
mogo marks bw-theatre sx,300x250,7,23,2,21
/All Apps/Apple App Store/Shopping,300x250,1,0,0,0
/All Apps/Google Play/Health & Fitness,320x50,20,3,2,1
BBB perf arts 5 black sx,300x600,1,20,0,20
mogo marks perf arts sx 2,320x100,1,4,0,4
/All Apps/Google Play/Productivity,300x50,6,3,0,3
dbm video sx,320x50,7258,10496,4270,6226
mogo marks hq100p sx,300x50,59,1354,63,1291
mogo marks native sx xsl1045 class c,320x50,7097,9974,2262,7712
mogo marks perf arts silver sx,300x600,34,140,38,102
mogo perf arts sx,160x600,64,515,26,489
ttd finance sx,320x50,464,629,145,484
DO NOT USE Tier 1* (CHANNEL),970x250,1541,2847,503,2344
/All Apps/Google Play/Business,728x90,1,0,0,0
at iab aff-im black sx,300x250,5,10,0,10
kid safe sx,300x250,3751,11601,1076,10525
maryland-dc sx,728x90,7,9,4,5
mogo marks lal branding (All) gold sx,336x280,3,23,1,22
mogo marks natl cat-aff-im sx 3,300x50,5,93,2,91
mogo marks video branding medium reach tail aggregate sx,300x250,14700,47834,4266,43568
ttd music sx,300x250,130,504,42,462
/All Apps/Apple App Store/Games/Board,160x600,11,2,1,1
/All Apps/Apple App Store/Lifestyle,300x250,133,3,2,1
DO NOT USE Tier 1,300x50,98,1960,62,1898
Triad Stage Local sx,300x250,1,0,0,0
mogo marks agg sx xsl37589,300x250,18719,69200,5611,63589
mogo marks branding comp rate gold video sx,970x90,4,2,0,2
mogo marks branding drhbx gold sx,970x250,680,1586,313,1273
/All Apps/Apple App Store/Newsstand/Regional News,728x90,97,5,1,4
5a kpi sx,300x600,0,4,0,4
Duxiana - Underperformance Blacklist,300x250,100,3,2,1
mogo marks disney sx,300x600,0,10,0,10
mogo marks video sx xsl44760 class a,300x250,2148,5067,555,4512
/All Apps/Apple App Store/Games/Card,300x250,101,3,3,0
mogo marks natl cat-aff-im sx 2,300x250,3525,9580,1152,8428
mogo marks perf arts silver sx,970x250,47,182,61,121
sfoc pslx 2018 sx (Jun_2018),320x50,1018,4577,599,3978
Android Movers and Shakers,320x100,1,0,0,0
mogo marks pav kpi hx,300x600,609,2965,310,2655
/All Apps/Apple App Store/Newsstand,300x600,63,1,0,1
Android Top Selling Free Sports,300x250,17,1,1,0
DO NOT USE Microsoft Bin (001),728x90,737,160,15,145
DO NOT USE Tier 3 (2),320x100,4,14,3,11
mogo black sx,300x600,108,363,43,320
mogo centro sx US (2014),300x250,1209,3328,390,2938
mogo marks los angeles sx,160x600,6,11,5,6
mogo marks pav kpi sx 3,970x250,427,1062,180,882
sfoc marks kpi sx (062018),160x600,0,1,0,1
ttd education sx,250x250,0,1,0,1
ttd travel sx,970x250,106,197,37,160
/All Apps/Google Play/Weather,300x50,6,0,0,0
mogo marks branding comp rate silver video sx,970x90,4,3,0,3
mogo marks branding drhbx silver sx,970x90,16,19,1,18
mogo marks kpi mdx sx xls9297,728x90,343,2598,139,2459
DO NOT USE Rubicon,300x50,0,11,0,11
co top 41 converting,728x90,1,3,0,3
mogo marks dallas sx,300x600,20,53,12,41
mogo marks native medium reach tail aggregate sx,970x90,14,19,0,19
mogo marks pav kpi sx,300x50,2,18,2,16
ttd kids sx,300x50,11,496,7,489
/All Apps/Google Play/Sports,300x250,20,1,1,0
Provident High CTR List ,300x600,10,2,0,2
kid safe sx,970x90,5,0,0,0
mogo marks native (sharethrough) unique can sx,336x280,0,2,0,2
mogo marks nyc sx,160x600,51,372,22,350
mogo marks wedding sx,300x600,2,54,7,47
ttd news sx,320x50,10514,10853,5277,5576
tz - Local Seattle sx,300x250,13,22,2,20
/All Apps/Google Play/Games/Racing,320x50,21,3,2,1
/All Apps/Google Play/Media & Video,728x90,1,0,0,0
mogo marks branding max reach sx,300x100,1,0,0,0
mogo marks perf arts sx 11,728x90,36,159,14,145
mogo sf local sx,728x90,66,640,17,623
pac esports sx,160x600,21,103,6,97
/All Apps/Google Play/Games/Racing,728x90,8,0,0,0
CST KPI List,300x600,6,5,3,2
mogo marks natl cat-aff-im sx 3,160x600,95,665,34,631
mogo marks perf arts sx 5 rx1,300x50,0,10,0,10
mogo marks perf arts sx 6,728x90,90,403,29,374
mogo sports sx,970x250,72,169,20,149
/All Apps/Google Play/Entertainment,728x90,6,1,1,0
Chicago T1 sites,320x50,34,30,19,11
Mogo DBM premium video sx,320x50,7029,10096,4214,5882
Mogo DBM premium video sx,728x90,1932,10662,589,10073
Pac Fox Atlanta EXCLUSION List,250x250,1,0,0,0
mogo marks lal branding (All) platinum sx,250x250,0,1,0,1
mogo marks pav kpi sx 2,300x50,10,180,7,173
mogo marks xsl_ks0001 sx,970x250,1929,3490,660,2830
/All Apps/Apple App Store/Book,320x50,173,1,0,1
Channel of Top Global Sites for Nielsen Video Ads - DO NOT EDIT,468x60,0,3,0,3
mogo marks classical music sx,320x50,7,29,3,26
mogo marks lal branding (All) gold sx,970x90,14,10,0,10
ttd food sx,200x200,0,1,0,1
Channel of Top US Sites for Nielsen Display Ads - DO NOT EDIT,300x50,325,9290,239,9051
DO NOT USE Invite December Brand Safe List,336x280,2,15,0,15
mogo marks branding tier 1 sx xls37852,970x250,1889,3445,652,2793
mogo marks detroit sx,300x600,20,64,3,61
mogo marks native sx xsl1045 class b,300x250,2305,6578,585,5993
mogo universal rt+ob black sx,160x600,4,8,2,6
provident shortlist ,300x50,86,2294,85,2209
sfoc marks lal custom sx,300x600,1,1,1,0
ttd education sx,320x100,21,21,11,10
Channel of Top US Sites for Nielsen Video Ads - DO NOT EDIT,Unknown,575,35,0,35
Channel of Top US Sites for Nielsen Video Ads - DO NOT EDIT,468x60,0,4,0,4
Diablo DVC Shortlist (Advertiser Level),160x600,18,4122,34,4088
mogo marks expedia sx,728x90,2,51,1,50
mogo marks lal (purchase) gold sx,970x90,11,11,0,11
mogo marks lal branding (All) silver sx,336x280,5,26,1,25
mogo perf arts sx,336x280,0,1,0,1
mogo marks branding elite tier sx xls37852,728x90,241,1372,82,1290
mogo marks kpi mdx sx xls9297,300x50,4,138,4,134
mogo marks native high reach tail aggregate sx,728x90,5236,28073,1856,26217
mogo marks video sx xsl44760 class c,728x90,3145,17724,1042,16682
Performing Arts Fort Worth Top sx,300x600,6,7,1,6
mogo marks native (sharethrough) unique can sx,970x250,199,328,40,288
mogo marks san francisco sx,728x90,60,565,26,539
sfjazz travel sx,728x90,4,40,2,38
Stratford KPI sx,728x90,1,25,1,24
mogo marks native sx xsl1045 class b,320x50,2073,3491,654,2837
mogo marks playbill sx x3e,320x50,149,694,73,621
mogo marks t1 brand sx trim,300x600,1839,6050,634,5416
mogo marks trip advisor sx,300x600,6,53,0,53
mogo marks video sx xsl44760 class b,300x250,4646,12404,1332,11072
ttd news sx,300x50,34,523,25,498
Stratford Black RT SX,320x50,1,5,1,4
mogo marks high intenders sx,320x50,297,1368,130,1238
mogo marks kpi achievers sx,320x100,1,4,0,4
mogo marks lal (purchase) gold sx,250x250,0,2,0,2
mogo marks los angeles sx,728x90,41,24,7,17
/All Apps/Google Play/Photography,300x50,1,0,0,0
mogo marks nyc sx,728x90,166,877,57,820
mogo marks nyt sx,300x600,12,29,10,19
mogo marks sports sx,300x50,18,74,7,67
mogo marks video branding max reach tail aggregate sx,200x200,0,2,0,2
mogo marks visual arts sx,160x600,17,6,1,5
Android Top Selling Free News and Magazines,320x50,265,41,13,28
mogo marks t1 brand kpi sx x8t,970x90,1,4,0,4
/All Apps,970x250,33,2,2,0
/All Apps/Apple App Store/Games/Action,320x50,42,5,5,0
/All Apps/Google Play/Games/Adventure,300x250,4,1,1,0
Android Top Selling Free News and Magazines,728x90,17,2,1,1
Channel of Top US Sites for Nielsen Display Ads - DO NOT EDIT,160x600,5389,22020,1652,20368
NYPR whitelist sx (Advertiser Level),970x250,0,1,0,1
ttd education sx,300x600,281,1026,59,967
Pac Private Events/Wedding sx,970x250,2,2,0,2
mogo canada t1 sx,970x90,5,7,0,7
sfoc marks kpi sx (062018),320x50,99,647,57,590
sfoc pslx 2018 sx (Jun_2018),300x250,288,3866,255,3611
zt local austin sx,320x50,9,50,5,45
Broadway sx,728x90,0,4,0,4
kid safe sx,200x200,0,1,0,1
mogo marks perf arts sx 5 epx1,320x100,1,11,0,11
mogo marks video sx xsl44760 class a,970x250,329,287,23,264
/All Apps/Apple App Store/Business,300x600,4,0,0,0
/All Apps/Apple App Store/Games,160x600,142,3,2,1
/All Apps/Apple App Store/Games/Card,970x250,22,0,0,0
/All Apps/Apple App Store/Sports,320x50,235,4,1,3
/All Apps/Google Play/Books & Reference,320x50,107,27,14,13
5a local sx seattle,728x90,1,3,0,3
mogo marks natl elite cat-aff-im sx,970x90,2,4,0,4
mogo marks video branding medium reach tail aggregate sx,200x200,0,2,0,2
sfoc stratford hqcat sx,300x600,55,492,47,445
Channel of Top non-US Sites for Nielsen Video Ads - DO NOT EDIT,250x250,6,4,0,4
DO NOT USE Tier 1,336x280,2,24,1,23
South Coast Rep Perf Arts 5 black sx,320x50,0,1,0,1
mogo marks native sx xsl1045 class a,320x50,1470,2865,474,2391
mogo marks natl cat-aff-im sx 3,336x280,0,1,0,1
ttd health sx,160x600,68,450,9,441
/All Apps/Apple App Store/Games/Casino,728x90,571,55,53,2
DO_NOT_USE Mobile - MoPub - Games,300x250,1,0,0,0
mogo marks branding comp rate platinum video sx,160x600,263,530,96,434
mogo marks native (sharethrough) unique us sx,300x600,647,2061,180,1881
mogo marks travel sx,160x600,36,379,11,368
Channel of Top US Sites for Nielsen Display Ads - DO NOT EDIT,320x100,141,276,55,221
GG KPI sx,160x600,2,0,0,0
Lynn Grad,300x250,45,286,27,259
mogo marks perf arts branding high reach sx,300x250,555,2596,233,2363
ttd male sx,728x90,418,1589,116,1473
BR Native sx,160x600,1,3,1,2
Lynn DMAC,728x90,1,8,0,8
mogo marks branding increased reach sx,300x50,282,9111,214,8897
mogo marks toronto sx,300x250,183,1142,89,1053
ttd sports sx,728x90,296,1082,53,1029
/All Apps/Apple App Store/Health & Fitness,728x90,12,0,0,0
/All Apps/Apple App Store/Shopping,320x50,6,0,0,0
Channel of Top non-US Sites for Nielsen Video Ads - DO NOT EDIT,320x50,14745,20674,6339,14335
education master sx,300x50,48,1300,38,1262
mogo marks branding increased reach sx,120x600,1,0,0,0
mogo marks hq100p sx,200x200,0,1,0,1
mogo marks visual arts sx,970x250,2,0,0,0
ttd education sx,970x90,2,4,0,4
DO NOT USE Tier 1,300x600,3671,12822,1288,11534
mogo marks nyt sx,970x90,1,2,0,2
mogo marks perf arts sx 5 rx1,320x100,1,11,0,11
ttd tech sx,300x50,0,201,0,201
DO NOT USE Mobile - MoPub - Games/Computer & Video Games/Music & Dance Games,320x50,60,0,0,0
mogo marks branding tier 2 sx xls37852,200x200,0,2,0,2
mogo marks bw-theatre sx,320x50,2,4,1,3
mogo marks xsl_800p sx,468x60,0,1,0,1
sfoc pslx 2018 sx (Jun_2018_Archived),728x90,225,3245,177,3068
mogo marks wedding sx,300x50,0,6,0,6
ttd health sx,300x250,240,1945,72,1873
MCE Blacklist,160x600,0,2,0,2
mogo marks t1 brand sx trim,320x50,9020,11234,4605,6629
mogo marks trip advisor sx,320x50,37,238,7,231
mogo marks wsj sx x4v,970x250,7,7,1,6
/All Apps/Google Play/Sports,300x50,6,0,0,0
Channel of Top US Sites for Nielsen Video Ads - DO NOT EDIT,300x600,4914,17817,1703,16114
Performing Arts Fort Worth Top sx,320x50,8,16,0,16
mogo CBS Interactive sx,728x90,61,316,26,290
mogo marks natl elite cat-aff-im sx,970x250,441,1157,227,930
mogo marks pav kpi hx,300x50,12,368,20,348
ttd beauty sx,160x600,0,22,0,22
ttd news sx,970x250,976,2027,393,1634
/All Apps/Apple App Store/Entertainment,300x250,497,18,18,0
/All Apps/Apple App Store/Games,300x600,2905,414,381,33
/All Apps/Apple App Store/Reference,300x50,4,2,0,2
Android Top Selling Free Education,300x250,131,71,48,23
Arizona Theatre Company - Site List,300x250,7,8,1,7
DO NOT USE Mobile - MoPub - People & Society,300x250,6,1,0,1
mogo marks elite kpi achievers sx,728x90,230,1568,87,1481
mogo marks lal branding (All) silver sx,250x250,1,10,0,10
mogo mba tier 2 sx,160x600,72,388,15,373
/All Apps/Apple App Store/Games/Puzzle,300x250,16,2,2,0
Arvada local sx,300x250,4,28,2,26
Cal Performances sf local + t1 brand black sx,300x250,7,2,0,2
Channel of Top non-US Sites for Nielsen Video Ads - DO NOT EDIT,Unknown,575,35,0,35
Channel of Top non-US Sites for Nielsen Video Ads - DO NOT EDIT,468x60,0,1,0,1
University of Colorado--Shortlist- HighCTR/ high CPA ,300x250,0,7,0,7
/All Apps/Apple App Store/Food & Drink,300x50,2,0,0,0
Android Top Selling Free Social,728x90,17,0,0,0
DO NOT USE Tier 2,250x250,0,5,0,5
mogo marks branding max reach sx,200x200,0,3,0,3
mogo marks native (sharethrough) unique us sx,160x600,138,586,29,557
mogo music sx,300x50,1,22,1,21
/All Apps/Apple App Store/Games,300x250,413,16,16,0
DO NOT USE Invite December Brand Safe List,160x600,1227,3762,349,3413
DO NOT USE Mobile - MoPub - Jobs & Education,320x50,5,0,0,0
mogo black sx,300x50,14,198,10,188
mogo marks native sx xsl1045 class c,300x600,1050,4459,325,4134
ttd auto sx,320x50,64,418,7,411
ttd finance sx,300x600,426,1545,169,1376
/All Apps/Google Play/Games/Sports,320x50,29,1,1,0
/All Apps/Google Play/Games/Word,300x600,53,14,12,2
DO NOT USE Tier 3* (CHANNEL) (2),300x600,125,516,51,465
Greg's GG KPI + relevant sites list,160x600,1,0,0,0
Mogo DBM basic video sx,320x50,1220,1014,352,662
Performing Arts Fort Worth Top sx,728x90,2,7,1,6
mogo marks branding comp rate gold video sx,250x250,1,1,0,1
mogo marks natl elite cat-aff-im sx,320x100,0,4,0,4
ttd news sx,320x100,38,46,18,28
DO NOT USE Tier 2* (CHANNEL),970x250,74,77,11,66
dbm video sx,300x600,2034,6848,714,6134
mogo marks email sx,250x250,0,2,0,2
mogo marks trip advisor sx,728x90,5,116,1,115
/All Apps/Google Play/Health & Fitness,300x600,5,1,1,0
Channel of Top Global Sites for Nielsen Video Ads - DO NOT EDIT,320x50,27251,34368,9964,24404
Duxiana - KPI sx,970x250,80,1,0,1
mogo education sx,300x50,13,591,7,584
mogo marks t1 brand sx trim,728x90,2295,6721,514,6207
finn dallas native sx,300x50,0,9,0,9
mogo marks broadwayworld sx,300x600,2,35,2,33
mogo marks elite kpi achievers sx,300x50,2,18,2,16
mogo marks native (sharethrough) unique can sx,200x200,0,1,0,1
DO NOT USE Tier 3* (CHANNEL) (2),160x600,197,633,45,588
DO NOT USE fgu test public channel,160x600,10,58,2,56
dso kpi audx sx,320x50,10,345,8,337
mogo CBS Interactive sx,300x50,14,98,6,92
mogo marks jazz & blues sx,320x100,1,0,0,0
mogo marks pav kpi sx 3,320x50,482,1102,164,938
mogo marks san francisco sx,970x250,3,7,2,5
5a kpi sx,320x100,0,4,0,4
BR Native sx,320x50,77,151,31,120
Brandcast Blacklist ,728x90,453,5720,189,5531
DO NOT USE Mobile - MoPub - Arts & Entertainment/Entertainment Industry/Recording Industry,320x50,60,0,0,0
mogo marks video sx xsl44760 class c,970x250,1458,2615,457,2158
/All Apps/Google Play/Communication,728x90,1,0,0,0
/All Apps/Google Play/News & Magazines,320x50,505,57,15,42
/All Apps/Google Play/Weather,300x600,2,5,1,4
DO NOT USE Invite December Brand Safe List,300x250,6687,22574,2056,20518
Stratford KPI sx,970x250,1,29,0,29
mogo marks native (sharethrough) unique us sx,300x250,1965,6519,518,6001
mogo marks natl cat-aff-im sx,970x250,818,2093,402,1691
pac canada sports sx,300x600,213,609,69,540
sfjazz travel sx,970x250,5,5,0,5
ttd kids sx,300x250,154,550,59,491
ttd travel sx,320x50,3390,4313,3071,1242
/All Apps/Apple App Store/Business,300x250,73,4,2,2
/All Apps/Apple App Store/Navigation,728x90,7,0,0,0
/All Apps/Google Play/Games,336x280,4,4,4,0
Android Top Selling Free Travel and Local,300x600,2,0,0,0
DO NOT USE Rubicon,300x250,210,958,96,862
GG KPI sx,320x50,17,9,2,7
dbm video sx,Unknown,575,35,0,35
dbm video sx,160x600,354,1100,125,975
mogo marks branding elite tier sx xls37852,970x250,462,1162,240,922
mogo marks native high reach tail aggregate sx,970x250,1765,3506,580,2926
mogo marks pav kpi sx,300x250,324,1455,159,1296
mogo marks xsl_74205 (4p dims) sx ,336x280,0,2,0,2
ttd real estate sx,300x50,1,6,1,5
/All Apps/Apple App Store/Music,320x100,1,0,0,0
Channel of Top Global Sites for Nielsen Display Ads - DO NOT EDIT,468x60,1,5,0,5
Chicago T1 sites,300x250,85,102,50,52
Mogo DBM premium video sx,300x250,6879,20848,2014,18834
debartolo local site list,160x600,0,2,0,2
mogo CBS Interactive sx,970x250,11,34,2,32
mogo marks chicago sx,300x600,17,30,6,24
mogo marks xsl_ks0001 sx,300x50,141,4211,135,4076
/All Apps/Google Play/Games/Racing,300x250,10,0,0,0
mogo marks pav kpi sx,728x90,80,546,40,506
mogo marks perf arts sx 2,300x50,1,45,1,44
mogo marks cincinnati sx,300x600,4,9,2,7
mogo marks classical music sx,300x250,4,16,2,14
pac motorsports sx,300x50,26,447,11,436
DO NOT USE Rubicon,728x90,76,652,33,619
mogo marks broadwayworld sx,320x50,2,19,0,19
mogo marks native sx xsl1045 class a,970x90,0,4,0,4
mogo marks sports sx,160x600,18,85,1,84
mogo marks video sx xsl44760 class b,320x100,13,18,7,11
mogo marks xsl_74205 (4p dims) sx ,250x250,0,2,0,2
/All Apps/Google Play/Weather,320x50,648,112,62,50
mogo marks elite kpi achievers sx,970x250,467,1187,239,948
ttd food sx,300x50,18,746,32,714
/All Apps/Apple App Store/Games/Strategy,320x50,12,0,0,0
DO NOT USE Tier 3* (CHANNEL) (2),300x250,295,1922,104,1818
mogo cult soph sx,160x600,202,888,46,842
mogo marks branding comp rate silver video sx,320x50,11271,14018,5456,8562
mogo marks branding drhbx silver sx,320x50,17653,27899,7265,20634
Channel of Top US Sites for Nielsen Video Ads - DO NOT EDIT,300x250,17682,52234,4741,47493
mogo marks playbill 5 sx x9z,160x600,7,22,0,22
ttd auto sx,728x90,36,203,6,197
ttd entertainment sx,Unknown,575,35,0,35
ttd kids sx,160x600,356,276,87,189
/All Apps/Apple App Store/Games/Music,320x50,7,0,0,0
/All Apps/Google Play/Games/Word,300x250,17,2,2,0
/All Apps/Google Play/Health & Fitness,300x250,6,1,0,1
DO NOT USE Rubicon,160x600,256,191,60,131
mogo marks native medium reach tail aggregate sx,320x50,22340,30263,8785,21478
mogo marks perf arts branding high reach sx,970x250,70,224,67,157
mogo marks sacramento sx,970x250,2,0,0,0
mogo marks toronto sx,970x250,5,39,0,39
Channel of Top Global Sites for Nielsen Video Ads - DO NOT EDIT,728x90,6028,29731,1983,27748
DO NOT USE Mobile - MoPub - Arts & Entertainment/Music & Audio,320x50,60,0,0,0
DO NOT USE fgu test public channel,300x600,9,14,3,11
Mogo DBM basic video sx,728x90,164,700,60,640
dbm video sx,300x250,7072,22463,2069,20394
ttd finance sx,300x250,1978,4376,615,3761
/All Apps/Apple App Store/Games/Strategy,728x90,16,3,3,0
/All Apps/Apple App Store/Social Networking,320x50,453,3,1,2
DCPA display local sx,300x600,0,2,0,2
DO NOT USE Invite US Expandable Enabled Sites,300x50,3,86,2,84
DO NOT USE Tier 2* (CHANNEL),320x100,12,12,5,7
mogo marks branding elite tier sx xls37852,970x90,1,2,0,2
mogo marks branding tier 3 sx xls37852,250x250,0,5,0,5
mogo marks native sx xsl1045 class c,300x250,3752,10952,988,9964
mogo marks video sx xsl44760 class c,970x90,9,8,0,8
mogo marks branding tier 2 sx xls37852,160x600,1093,4499,285,4214
mogo marks perf arts sx 2,300x600,51,162,33,129
mogo marks playbill 5 sx x9z,300x50,0,2,0,2
Channel of Top US Sites for Nielsen Display Ads - DO NOT EDIT,468x60,2,7,0,7
mogo marks hq100p sx,160x600,1603,4866,577,4289
mogo marks lal (purchase) silver sx,970x250,1661,3483,595,2888
mogo marks natl canada cat-aff-im sx,300x250,2047,5646,725,4921
mogo marks video branding max reach tail aggregate sx,320x100,134,248,46,202
mogo marks wine sx,728x90,5,79,4,75
/All Apps/Apple App Store/Games/Arcade,300x600,3,0,0,0
/All Apps/Apple App Store/Photo & Video,300x250,2,0,0,0
Seattle Local sx,728x90,5,0,0,0
mogo marks natl cat-aff-im sx,336x280,0,2,0,2
mogo marks perf arts gold sx,336x280,0,1,0,1
ttd food sx,300x600,157,1142,59,1083
/All Apps/Apple App Store/Education,300x250,2,0,0,0
DO NOT USE Tier 3* (CHANNEL),120x600,1,0,0,0
finn dallas native sx,320x50,252,970,112,858
magic theatre top performing sx,728x90,3,10,1,9
ttd shopping sx,970x90,4,0,0,0
/All Apps/Google Play/Games/Music,320x50,20,0,0,0
/All Apps/Google Play/Travel & Local,300x250,3,4,2,2
Mogo DBM select video sx,160x600,27,200,5,195
dbm native sx (adx),300x250,3871,10211,1053,9158
mogo marks perf arts sx 5 epx1,970x90,0,1,0,1
ttd gaming sx,250x250,0,2,0,2
/All Apps/Apple App Store/Games/Board,970x250,6,1,1,0
Android Top Selling Free Books and Reference,300x50,1,4,4,0
DO NOT USE Tier 2* (CHANNEL),728x90,901,7652,322,7330
Mogo DBM premium video sx,250x250,1,3,0,3
Stratford KPI revised,970x250,9,70,9,61
/All Apps/Apple App Store/Weather,300x600,1,0,0,0
Duxiana- Bad Site List(Allan) ,160x600,6,0,0,0
Lynn Grad,728x90,0,25,0,25
mogo marks xsl_ks20780 sx,300x50,251,7857,199,7658
ttd health wellness sx,970x250,21,35,16,19
Diablo Blacklist ,728x90,4,651,7,644
RCU Blacklist Sites (CPA),300x250,1,3,0,3
mogo marks branding increased reach sx,200x200,0,3,0,3
mogo marks natl cat-aff-im sx,970x90,2,6,0,6
sfoc stratford hqcat sx,160x600,0,1,0,1
Duxiana - KPI sx,728x90,45,6,0,6
mogo marks branding max reach sx,970x250,2186,4103,714,3389
mogo marks native high reach tail aggregate sx,970x90,22,26,1,25
mogo marks perf arts branding high reach sx,320x50,424,1736,167,1569
mogo marks toronto sx,320x50,52,248,36,212
mogo marks travel sx,300x250,34,450,8,442
/All Apps/Apple App Store/Games/Board,728x90,1927,179,169,10
Provident High CTR List ,300x250,229,2,0,2
bbb kpi sx (2019),300x600,1,76,0,76
mogo marks branding drhbx platinum sx,970x90,2,5,0,5
mogo marks video branding extended reach tail aggregate sx,970x90,11,10,0,10
mogo marks wedding sx,300x250,0,26,0,26
zt local austin sx,160x600,0,2,0,2
/All Apps/Apple App Store/Music,160x600,1,0,0,0
/All Apps/Google Play/Games/Educational,320x50,8,1,1,0
DO NOT USE Tier 3,120x600,1,0,0,0
Duxiana - KPI sx,320x50,1941,1152,1120,32
Stratford KPI revised,320x50,28,110,23,87
mogo marks branding max reach sx,320x50,36288,50822,12753,38069
mogo marks xsl_ks0001 sx,250x250,1,16,0,16
mogo music sx,300x600,9,62,4,58
/All Apps/Apple App Store/Games/Board,320x50,637,19,13,6
/All Apps/Apple App Store/Reference,300x250,1,0,0,0
DO NOT USE Tier 3,300x50,82,2820,87,2733
mogo biz-fi sx,336x280,0,1,0,1
mogo marks broadway sx,336x280,0,1,0,1
mogo marks xsl_ks20780 sx,120x600,1,0,0,0
ttd shopping sx,300x50,2,219,2,217
DO NOT USE Invite US Expandable Enabled Sites,300x600,64,188,15,173
mogo black sx,300x250,369,968,87,881
mogo education sx,300x600,42,278,7,271
mogo marks branding tier 1 sx xls37852,250x250,4,10,0,10
mogo marks dallas sx,300x250,48,112,19,93
mogo marks high intenders sx,160x600,20,123,6,117
ttd health wellness sx,320x50,722,3001,270,2731
DCPA rt black sx,160x600,1,9,0,9
DO NOT USE AppNexus - Collective Media,336x280,4,1,0,1
Nashville Symphony black list all adgroups,970x250,0,11,0,11
iab aff-im black sx,970x250,1,0,0,0
mogo marks bwwpb sx,336x280,0,1,0,1
mogo marks pav kpi hx,300x250,3077,8572,964,7608
pac canada sports sx,300x50,19,67,7,60
/All Apps/Google Play/Games/Card,300x250,47,11,9,2
DO NOT USE All Google Anonymous,728x90,0,1,0,1
mogo marks nyc sx,970x250,434,1061,228,833
mogo marks pav kpi hx,970x90,1,2,0,2
provident shortlist ,160x600,434,1528,109,1419
mogo centro sx US (2014),970x90,4,2,1,1
mogo marks branding tier 3 sx xls37852,320x100,49,108,24,84
mogo marks ttd obx kitchen premium sink sx,300x600,3916,14223,1296,12927
mogo marks xsl_74205 (2p dims) sx ,300x600,1145,4845,455,4390
/All Apps/Google Play/Tools,300x250,105,13,12,1
Channel of Top non-US Sites for Nielsen Display Ads - DO NOT EDIT,300x100,1,0,0,0
DO NOT USE Tier 1* (CHANNEL),300x50,98,1960,62,1898
mogo marks bwwpb sx,160x600,55,385,22,363
mogo marks native high reach tail aggregate sx,468x60,1,3,0,3
mogo marks video sx xsl44760 class c,468x60,0,1,0,1
mogo t1 brand sx,300x600,1854,6097,639,5458
sfoc 2018 marks stratford premium sx,728x90,145,2053,116,1937
ttd family parent sx,728x90,300,910,97,813
/All Apps/Apple App Store,300x250,1764,67,50,17
DO_NOT_USE Mobile - MoPub - Games,320x50,27,1,1,0
Mogo DBM select video sx,728x90,83,881,34,847
mogo marks branding drhbx gold sx,300x50,23,918,9,909
mogo mba tier 1 sx,300x250,95,607,34,573
ttd gaming sx,300x250,440,981,115,866
DO NOT USE AppNexus - Collective Media,Unknown,575,35,0,35
mogo biz-fi sx,160x600,21,128,5,123
mogo marks los angeles sx,970x250,1,0,0,0
sfoc pslx 2018 sx (Jun_2018_Archived),160x600,101,520,59,461
/All Apps/Apple App Store/Games/Word,300x250,297,11,11,0
Duxiana - Longtail Blacklist,320x50,131,4,3,1
LSSU url v1,970x250,1,103,1,102
dbm native sx (adx),160x600,113,592,20,572
dbm video sx,300x50,48,1603,30,1573
mogo marks ballet sx,320x50,3,3,0,3
mogo marks lal branding (All) platinum sx,970x90,5,1,0,1
mogo marks los angeles sx,300x600,13,9,2,7
mogo marks xsl_ks20780 sx,728x90,7691,39231,2582,36649
ttd finance sx,300x50,8,119,2,117
ttd spanish sx,300x250,81,72,17,55
mogo marks branding tier 3 sx xls37852,300x250,3759,14006,1275,12731
mogo marks native sx xsl1045 class c,300x50,42,918,34,884
ocfta local madison sx,300x250,2,17,0,17
provident shortlist ,250x250,2,4,0,4
Channel of Top US Sites for Nielsen Display Ads - DO NOT EDIT,250x250,10,23,0,23
DO NOT USE Tier 3,970x250,292,546,125,421
Lynn Undergrad,300x250,87,300,54,246
mogo marks broadwayworld sx,320x100,0,4,0,4
mogo marks nyc sx,300x600,74,160,32,128
mogo marks perf arts sx 7,728x90,53,217,20,197
Channel of Top US Sites for Nielsen Video Ads - DO NOT EDIT,300x50,244,6768,165,6603
mogo marks branding max reach sx,336x280,26,129,6,123
mogo marks natl canada cat-aff-im sx,160x600,55,385,22,363
/All Apps/Google Play/Games/Word,300x50,7,1,0,1
Android Top Selling Free Books and Reference,728x90,3,0,0,0
Channel of Top Global Sites for Nielsen Video Ads - DO NOT EDIT,200x200,0,2,0,2
SP News Black sx,320x50,44,74,43,31
mogo marks lal (purchase) silver sx,970x90,14,16,0,16
ttd shopping sx,970x250,15,41,8,33
/All Apps/Google Play/Tools,160x600,1,0,0,0
Android Top Selling Free Weather,300x50,8,0,0,0
Channel of Top US Sites for Nielsen Display Ads - DO NOT EDIT,300x600,5934,23941,2036,21905
mogo marks branding increased reach sx,Unknown,575,35,0,35
mogo marks natl canada cat-aff-im sx,728x90,266,2284,110,2174
mogo marks video sx xsl44760 class b,336x280,0,2,0,2
ttd entertainment sx,970x250,670,1479,295,1184
ttd weather sx,300x250,198,825,87,738
/All Apps/Apple App Store/Games/Arcade,320x50,16,2,2,0
Android Top Selling Free Tools,300x250,112,15,10,5
dbm native sx (adx),728x90,1279,2682,189,2493
mogo marks kpi achievers sx,970x90,4,2,0,2
mogo perf arts sx,300x50,1,49,1,48
sfoc rtx kpi sx,160x600,38,61,19,42
ttd female sx,970x250,113,197,35,162
/All Apps/Google Play/Finance,300x250,1,1,0,1
DO NOT USE Tier 2,300x50,27,1810,17,1793
mogo marks branding increased reach sx,468x60,1,4,0,4
mogo marks branding max reach sx,468x60,1,5,0,5
mogo marks pav kpi sx 2,300x250,3171,8358,1007,7351
ttd food sx,320x50,1106,4528,395,4133
/All Apps/Apple App Store/News,970x90,1,0,0,0
/All Apps/Apple App Store/Photo & Video,728x90,11,1,1,0
Top Performing Sites,300x600,73,68,7,61
mogo marks perf arts sx 5 rx1,300x600,37,98,26,72
mogo marks xsl_74205 sx ,970x90,2,4,0,4
DO NOT USE Invite December Brand Safe List,200x200,0,1,0,1
DO NOT USE Tier 3* (CHANNEL),970x250,292,546,125,421
RCU KPI Sitelist 1 (CPA),300x600,1,3,0,3
dso custom hx,970x250,0,10,0,10
mogo financial services kpi sx,250x250,1,5,0,5
mogo marks coupon sx,300x50,0,2,0,2
provident shortlist ,300x600,2764,10907,1006,9901
debartolo local site list,300x250,0,21,0,21
dso custom hx,300x600,1,43,2,41
mogo marks branding tier 3 sx xls37852,160x600,690,2812,188,2624
mogo marks video branding max reach tail aggregate sx,728x90,6754,33182,2259,30923
pac canada sports sx,970x90,2,3,0,3
ttd entertainment sx,300x600,885,2888,289,2599
/All Apps/Apple App Store/Games/Trivia,300x600,17,0,0,0
/All Apps/Google Play,970x250,5,1,1,0
Android Top Selling Free Sports,300x600,12,0,0,0
DO NOT USE fgu test public channel,728x90,225,834,56,778
mogo marks xsl_800p sx,970x250,1931,3497,650,2847
sfoc kpi sx (acquisition 2019),970x250,14,107,16,91
/All Apps/Apple App Store/Newsstand/News & Politics,300x600,63,1,0,1
ttd female sx,300x600,191,1226,67,1159
/All Apps/Apple App Store/Games/Racing,728x90,9,1,1,0
/All Apps/Google Play/Games/Casino,300x250,4,0,0,0
DCPA display local sx,728x90,4,60,2,58
mogo marks agg sx xsl37589,336x280,20,93,4,89
mogo marks video branding medium reach tail aggregate sx,336x280,12,15,2,13
/All Apps/Apple App Store/Games/Word,160x600,1,0,0,0
/All Apps/Google Play/Photography,300x250,3,0,0,0
DO NOT USE Tier 3* (CHANNEL),300x600,1118,5317,325,4992
mogo marks sports sx,300x250,439,1273,100,1173
5a local sx seattle,300x600,0,2,0,2
DCPA Video black sx,970x250,1,0,0,0
DO NOT USE Invite US Expandable Enabled Sites,300x250,356,1568,113,1455
mogo education sx,300x250,343,1261,128,1133
mogo marks elite kpi achievers sx,160x600,899,2185,331,1854
ttd tech sx,970x250,37,59,20,39
/All Apps/Google Play/Games/Educational,728x90,3,1,1,0
SP black sx,160x600,0,1,0,1
Stratford KPI revised,728x90,7,85,4,81
mogo marks branding increased reach sx,970x250,2127,4041,694,3347
mogo marks branding max reach sx,728x90,9107,47770,3054,44716
mogo marks sacramento sx,320x50,117,184,49,135
mogo marks video sx xsl44760 class b,160x600,559,1438,227,1211
ttd health sx,250x250,0,2,0,2
bbb kpi sx (2019),300x250,7,99,4,95
mogo marks branding comp rate platinum video sx,250x250,0,1,0,1
mogo marks lal (purchase) gold sx,320x50,7204,15053,4398,10655
mogo marks perf arts sx 5 epx1,300x50,0,10,0,10
/All Apps/Apple App Store/Newsstand,300x250,283,15,7,8
Channel of Top non-US Sites for Nielsen Display Ads - DO NOT EDIT,970x90,15,16,0,16
education master sx,970x250,581,1226,211,1015
ttd health wellness sx,728x90,97,1296,32,1264
/All Apps/Apple App Store/Food & Drink,300x250,4,0,0,0
/All Apps/Apple App Store/Games/Casino,300x600,578,43,33,10
mogo music sx,300x250,21,103,9,94
ttd male sx,336x280,0,2,0,2
Android Top Selling Free Game,160x600,7,1,1,0
Diablo Blacklist ,300x50,0,9,0,9
mogo marks lal branding (All) platinum sx,160x600,304,1841,97,1744
mogo marks perf arts branding high reach sx,300x50,1,44,0,44
Lynn General,320x50,146,210,60,150
mogo marks detroit sx,970x250,0,4,0,4
/All Apps/Google Play/Games/Casual,160x600,1,1,0,1
mogo marks broadway sx,320x100,0,4,0,4
mogo marks houston sx,320x50,50,48,7,41
mogo marks outbound kpi sx x1a,970x90,4,2,0,2
mogo marks perf arts platinum sx,320x100,0,4,0,4
pac canada sports sx,300x250,697,2478,213,2265
Cal Perf KPI sx ,300x250,161,16,0,16
DO NOT USE Tier 3,300x250,3768,14058,1095,12963
mogo centro sx US (2014),250x250,0,2,0,2
mogo marks lal (purchase) silver sx,160x600,2928,16390,1015,15375
mogo marks native sx xsl1045 class b,320x100,2,8,4,4
ttd shopping sx,300x250,154,1652,66,1586
zt perf arts black sx 5,320x50,0,2,0,2
/All Apps/Apple App Store/Catalogs,320x50,1,0,0,0
/All Apps/Apple App Store/Games/Family,320x50,22,0,0,0
Android Top Selling Free Travel and Local,300x250,2,2,2,0
CST KPI List,970x250,1,1,1,0
DO NOT USE OAM FR,300x250,4,41,0,41
arizona opera top converters sx,320x50,71,155,43,112
mogo marks lal (purchase) platinum sx,336x280,0,1,0,1
mogo marks native standard reach (no) tail aggregate sx,336x280,6,14,3,11
mogo marks perf arts sx 5 epx1,300x600,33,95,25,70
mogo marks philadelphia sx,320x50,21,12,7,5
Android Top Selling Free Tools,160x600,1,0,0,0
Mercury Theater Chicago sx,160x600,22,30,17,13
maryland-dc sx,300x600,7,3,2,1
ttd spanish sx,320x50,350,394,74,320
zt perf arts black sx 5,300x250,0,5,0,5
/All Apps/Apple App Store/Games/Family,300x250,1,0,0,0
/All Apps/Apple App Store/Games/Word,728x90,144,10,7,3
KCPA Local sx,300x600,0,2,0,2
Mogo DBM premium video sx,320x100,36,45,16,29
fgu test public channel,160x600,10,58,2,56
mogo marks philadelphia sx,300x250,3,7,3,4
/All Apps/Google Play/Business,300x600,1,0,0,0
Lynn General,300x250,113,690,70,620
mogo black sx,336x280,0,1,0,1
mogo marks branding tier 3 sx xls37852,728x90,1138,6669,378,6291
ttd entertainment sx,970x90,4,6,0,6
/All Apps/Apple App Store/Games/Educational,728x90,17,4,4,0
Lynn Undergrad,320x50,69,93,25,68
arizona opera top converters sx,300x250,53,114,42,72
mogo lydia peacecenter test,160x600,1770,4764,590,4174
mogo marks agg sx xsl37589,468x60,1,5,0,5
mogo marks chicago sx,970x250,9,32,1,31
mogo marks houston sx,300x250,58,126,8,118
mogo marks video branding medium reach tail aggregate sx,468x60,1,3,0,3
mogo marks xsl_74205 (4p dims) sx ,160x600,442,1808,108,1700
/All Apps/Apple App Store/Newsstand/Regional News,300x600,63,1,0,1
Channel of Top US Sites for Nielsen Video Ads - DO NOT EDIT,200x200,0,2,0,2
Channel of Top non-US Sites for Nielsen Display Ads - DO NOT EDIT,160x600,3523,15798,1059,14739
DO NOT USE Tier 1,300x100,1,0,0,0
ocfta local madison sx,320x50,1,31,0,31
ttd male sx,300x50,6,180,5,175
/All Apps/Google Play/Games/Music,300x250,1,0,0,0
DCPA rt black sx,300x250,5,14,0,14
DO NOT USE Invite US Expandable Enabled Sites,160x600,138,530,37,493
DO NOT USE Tier 3 (2),300x50,5,181,4,177
mogo marks video branding extended reach tail aggregate sx,320x100,103,146,42,104
ttd real estate sx,300x600,6,22,1,21
mogo education sx,160x600,95,388,23,365
mogo marks lal branding (All) platinum sx,300x50,15,599,11,588
mogo marks ttd obx kitchen premium sink sx,336x280,3,12,1,11
mogo marks wsj sx x4v,300x600,38,198,13,185
mogo marks xsl_74205 (2p dims) sx ,336x280,0,2,0,2
Android Top Selling Free Health and Fitness,300x600,16,2,1,1
Pac Fox Atlanta EXCLUSION List,300x50,0,48,0,48
mogo marks lal (purchase) silver sx,300x50,101,4092,70,4022
sfjazz travel sx,320x50,303,388,313,75
/All Apps/Google Play/Games/Casual,300x50,3,0,0,0
APACTix Sitelist sx,320x50,12,23,0,23
Android Top Selling Free Entertainment,320x100,1,0,0,0
Channel of Top non-US Sites for Nielsen Display Ads - DO NOT EDIT,970x250,1528,3012,432,2580
mogo lydia peacecenter test,970x250,1105,1760,317,1443
mogo CBS Interactive sx,300x600,22,113,3,110
mogo marks native (sharethrough) unique can sx,320x50,7568,8587,1963,6624
mogo marks natl elite cat-aff-im sx,300x600,109,649,41,608
mogo t1 brand sx,336x280,2,2,1,1
Top Performing Sites,160x600,135,119,27,92
mogo marks kpi achievers sx,970x250,534,1267,251,1016
mogo marks native sx xsl1045 class c,200x200,0,1,0,1
mogo marks perf arts sx 5 rx1,160x600,88,688,34,654
ocfta local madison sx,728x90,2,21,0,21
sfoc pslx 2018 sx (Jun_2018),300x600,218,1788,196,1592
ttd health wellness sx,250x250,0,2,0,2
Channel of Top non-US Sites for Nielsen Video Ads - DO NOT EDIT,300x50,104,2566,76,2490
mogo cult soph sx,970x90,6,5,1,4
mogo education sx,336x280,1,1,1,0
mogo marks los angeles sx,320x50,123,106,50,56
mogo marks pav kpi sx 2,160x600,140,809,38,771
sfoc pslx 2019 sx (Mar_2019),160x600,123,580,80,500
ttd spanish sx,728x90,46,157,18,139
/All Apps/Google Play/Business,300x250,1,0,0,0
DO NOT USE Invite US Expandable Enabled Sites,336x280,0,1,0,1
dbm video sx,200x200,0,1,0,1
maryland-dc sx,300x250,135,74,52,22
mogo marks branding max reach sx,250x250,6,26,0,26
mogo marks perf arts silver sx,300x50,1,28,0,28
ttd weather sx,160x600,1,8,0,8
/All Apps/Apple App Store/Newsstand/Regional News,300x250,283,15,7,8
KCPA Local sx,300x250,0,15,0,15
Lynn Undergrad,728x90,30,123,21,102
mogo marks nyc sx,320x50,2407,955,549,406
mogo marks xsl_74205 sx ,970x250,1071,2088,398,1690
/All Apps/Google Play/Games/Puzzle,336x280,1,0,0,0
DO NOT USE Tier 1* (CHANNEL),250x250,2,6,0,6
Pac Fox Atlanta EXCLUSION List,320x50,140,158,37,121
mogo marks chicago sx,160x600,33,58,17,41
mogo marks lal (purchase) silver sx,320x50,13886,23789,6224,17565
/All Apps/Google Play/Games/Casual,320x50,132,34,26,8
allan- UOC  high click rate /  converter list ,320x50,0,1,0,1
/All Apps/Apple App Store/Music,300x50,3,0,0,0
Android Movers and Shakers,320x50,117,19,19,0
DO NOT USE Tier 2* (CHANNEL),970x90,4,9,0,9
at black perf arts sx 7,320x50,1,0,0,0
mogo marks native sx xsl1045 class a,970x250,409,234,22,212
mogo marks t1 brand sx trim,970x90,11,4,0,4
/All Apps/Apple App Store/Games/Role Playing,320x50,2,0,0,0
/All Apps/Google Play/Personalization,320x50,13,2,2,0
Android Top Selling Free Photography,320x50,85,3,3,0
Channel of Top Global Sites for Nielsen Video Ads - DO NOT EDIT,970x90,17,20,0,20
Diablo DVC Shortlist (Advertiser Level),728x90,28,8315,72,8243
mogo black rt sx,728x90,0,7,0,7
mogo marks branding drhbx gold sx,250x250,0,6,0,6
mogo marks branding drhbx platinum sx,336x280,0,1,0,1
mogo marks playbill 5 sx x9z,300x600,0,1,0,1
mogo marks xsl_800p sx,728x90,6293,33060,2091,30969
/All Apps/Google Play,728x90,203,15,14,1
DO NOT USE Tier 3 (2),320x50,757,995,234,761
mogo marks lal branding (All) platinum sx,320x50,4188,6280,3318,2962
mogo marks video branding extended reach tail aggregate sx,336x280,7,9,0,9
sfoc kpi sx (acquisition 2019),728x90,33,316,25,291
bbb kpi sx (2019),160x600,1,6,0,6
mogo marks branding drhbx platinum sx,320x100,3,16,0,16
mogo marks disney sx,728x90,8,65,3,62
mogo marks native high reach tail aggregate sx,320x50,25472,35027,9675,25352
mogo marks shakespeare sx,300x250,11,6,4,2
/All Apps/Google Play/Communication,320x50,64,5,3,2
Stratford KPI sx,320x50,11,124,7,117
education master sx,970x90,3,6,0,6
kid safe sx,320x100,5,32,2,30
mogo marks elite kpi achievers sx,300x600,137,580,56,524
mogo marks natl cat-aff-im sx,320x50,4604,4883,1356,3527
mogo marks natl cat-aff-im sx,728x90,617,4130,272,3858
mogo marks outbound kpi sx x1a,336x280,0,1,0,1
mogo marks perf arts gold sx,728x90,66,356,27,329
/All Apps/Apple App Store/Music,300x250,95,3,3,0
Duxiana- Bad Site List(Allan) ,300x250,24,0,0,0
mogo marks agg sx xsl37589,320x100,154,308,57,251
mogo marks jazz & blues sx,728x90,11,36,1,35
mogo marks san francisco sx,320x50,357,502,148,354
mogo marks video branding medium reach tail aggregate sx,320x100,125,179,44,135
ttd tech sx,970x90,3,2,0,2
/All Apps/Apple App Store/Productivity,728x90,33,0,0,0
5a kpi sx,728x90,1,2,0,2
Android Top Selling Free Game,300x50,59,0,0,0
Broadway sx,160x600,1,1,0,1
Channel of Top non-US Sites for Nielsen Display Ads - DO NOT EDIT,200x200,0,2,0,2
SP black sx,300x250,0,1,0,1
mogo financial services kpi sx,728x90,930,1924,87,1837
mogo marks branding elite tier sx xls37852,320x50,347,1526,147,1379
mogo marks branding increased reach sx,970x90,31,35,1,34
mogo marks natl cat-aff-im sx 2,320x100,12,21,7,14
mogo marks video sx xsl44760 class c,320x50,13474,17281,5971,11310
Broadway sx,300x250,0,1,0,1
mogo CBS Interactive sx,160x600,8,43,0,43
mogo marks lal (purchase) gold sx,728x90,1616,10563,528,10035
mogo marks native sx xsl1045 class a,300x600,366,1375,85,1290
mogo marks perf arts silver sx,336x280,0,1,0,1
mogo marks perf arts sx 5 rx1,970x90,0,1,0,1
Channel of Top US Sites for Nielsen Video Ads - DO NOT EDIT,250x250,10,13,0,13
mogo marks native (sharethrough) unique can sx,970x90,1,4,0,4
mogo marks natl cat-aff-im sx 2,300x50,9,217,6,211
/All Apps/Apple App Store/Games/Casino,300x250,94,3,3,0
education master sx,320x100,22,21,11,10
kid safe sx,300x50,23,265,9,256
pac esports sx,320x50,408,941,92,849
/All Apps/Apple App Store/Sports,300x600,3,0,0,0
/All Apps/Google Play/Books & Reference,300x600,29,2,2,0
Channel of Top non-US Sites for Nielsen Video Ads - DO NOT EDIT,336x280,9,4,0,4
South Coast Rep Perf Arts 5 black sx,300x600,0,1,0,1
mogo marks agg sx xsl37589,300x50,267,9148,210,8938
mogo marks pav kpi sx 2,970x90,1,4,0,4
mogo marks video branding medium reach tail aggregate sx,300x50,192,5321,133,5188
ttd tech sx,320x100,0,3,0,3
sfoc rtx kpi sx,970x250,0,4,0,4
ttd real estate sx,160x600,0,6,0,6
ttd weather sx,970x90,3,0,0,0
/All Apps/Google Play/Games/Educational,300x600,1,0,0,0
RCU KPI Sitelist 1 (CPA),320x50,12,86,2,84
Stratford KPI revised,300x600,30,342,37,305
Top Performing Sites,320x50,222,124,76,48
mogo marks branding tier 1 sx xls37852,336x280,3,10,1,9
mogo marks perf arts sx 5 rx1,320x50,257,1253,118,1135
/All Apps/Apple App Store/Utilities,300x50,6,0,0,0
DCPA video local sx,970x250,1,1,1,0
mogo marks pav kpi sx 2,728x90,316,2364,126,2238
sfoc pslx 2019 sx (Mar_2019),728x90,290,3723,245,3478
/All Apps/Apple App Store/Games/Board,300x600,2213,367,344,23
Channel of Top US Sites for Nielsen Display Ads - DO NOT EDIT,320x50,35837,45699,11895,33804
mogo marks disney sx,160x600,1,0,0,0
mogo marks video sx xsl44760 class b,250x250,0,3,0,3
ttd weather sx,728x90,70,249,30,219
mogo marks xsl_74205 (4p dims) sx ,320x100,0,4,0,4
provident shortlist ,320x50,18867,23720,7349,16371
ttd health wellness sx,300x600,48,283,9,274
ttd news sx,300x250,5601,13723,1727,11996
/All Apps/Apple App Store/Games/Card,160x600,131,1,1,0
DO NOT USE Tier 1* (CHANNEL),970x90,11,12,1,11
Duxiana - KPI sx,300x600,131,32,12,20
Duxiana - Underperformance Blacklist,160x600,22,1,0,1
mogo marks branding max reach sx,300x600,6235,25315,2204,23111
mogo marks jazz & blues sx,160x600,0,2,0,2
mogo marks pav kpi sx 3,300x50,8,104,5,99
mogo marks perf arts sx 5 rx1,728x90,147,752,50,702
mogo marks xsl_ks0001 sx,336x280,4,13,2,11
sfoc pslx 2019 sx (Mar_2019),320x50,1282,5386,775,4611
ttd travel sx,300x50,0,30,0,30
mogo marks elite kpi achievers sx,970x90,1,5,0,5
mogo mba tier 2 sx,300x600,347,1874,157,1717
/All Apps/Apple App Store/Weather,320x50,284,8,5,3
DO NOT USE Invite US Expandable Enabled Sites,970x250,22,27,8,19
Mogo DBM premium video sx,160x600,327,900,120,780
mogo education sx,970x250,31,72,6,66
Channel of Top Global Sites for Nielsen Video Ads - DO NOT EDIT,336x280,23,13,1,12
Mogo DBM basic video sx,336x280,3,0,0,0
Mogo dating sx,300x600,0,10,0,10
mogo marks perf arts sx 11,160x600,60,449,26,423
mogo music sx,970x250,2,5,1,4
mogo sf local sx,160x600,4,13,5,8
ttd beauty sx,300x600,24,266,8,258
bbb kpi sx (2019),970x250,2,8,0,8
mogo black sx,320x100,4,0,0,0
/All Apps/Apple App Store/Health & Fitness,320x50,32,0,0,0
RCU KPI Sitelist 1 (CPA),728x90,1,16,0,16
Top Performing Sites,970x250,94,31,11,20
mogo marks native standard reach (no) tail aggregate sx,200x200,0,2,0,2
Brandcast Blacklist ,160x600,91,240,17,223
Lynn DMAC,320x50,1,3,1,2
mogo biz-fi sx,728x90,262,1886,132,1754
ttd male sx,320x50,950,1362,275,1087
ttd sports sx,320x50,952,1037,185,852
mogo marks expedia sx,160x600,24,230,9,221
mogo marks perf arts sx 5 rx1,970x250,50,195,63,132
/All Apps/Apple App Store,970x90,1,0,0,0
Android Top Selling Free Social,300x250,135,17,14,3
Channel of Top US Sites for Nielsen Display Ads - DO NOT EDIT,970x250,2076,3961,681,3280
DO NOT USE Rubicon,250x250,0,1,0,1
Diablo Blacklist ,300x250,2,174,14,160
mogo marks perf arts gold sx,160x600,76,607,29,578
DO NOT USE AppNexus - Collective Media,728x90,1356,6803,441,6362
DO NOT USE Tier 2* (CHANNEL),300x250,1414,7100,401,6699
mogo marks bwwpb sx,728x90,29,127,12,115
mogo marks pav kpi sx 2,320x100,0,4,0,4
mogo marks perf arts branding high reach sx,300x600,57,280,44,236
mogo marks stratford (canada) sx,728x90,5,27,4,23
mogo marks toronto sx,300x600,70,274,39,235
sfoc pslx 2018 sx (Jun_2018_Archived),320x50,1018,4577,599,3978
/All Apps/Apple App Store/Finance,320x50,22,0,0,0
mogo marks branding comp rate platinum video sx,300x600,1370,3345,453,2892
mogo marks ticketing sx,300x250,12,277,2,275
ttd spanish sx,300x100,1,0,0,0
ttd travel sx,200x200,0,1,0,1
mogo cult soph sx,300x50,17,340,21,319
mogo marks branding elite tier sx xls37852,336x280,0,1,0,1
mogo marks kpi mdx sx xls9297,970x250,590,1609,297,1312
mogo marks lal (purchase) silver sx,320x100,83,155,41,114
mogo marks native high reach tail aggregate sx,336x280,10,25,3,22
mogo marks natl cat-aff-im sx 2,970x90,2,6,0,6
mogo marks ttd obx kitchen premium sink sx,250x250,1,16,0,16
mogo marks video sx xsl44760 class c,336x280,6,9,0,9
ttd real estate sx,320x50,29,69,8,61
/All Apps/Apple App Store/Games/Arcade,300x250,5,0,0,0
Android Top Selling Free Health and Fitness,320x50,10,3,1,2
mogo CBS Interactive sx,320x50,558,458,114,344
mogo marks natl elite cat-aff-im sx,320x50,295,1207,163,1044
mogo marks t1 brand kpi sx x8t,300x50,7,113,4,109
mogo t1 brand sx,250x250,1,3,0,3
pac motorsports sx,300x600,24,95,3,92
DO NOT USE Android Top Selling Free Media and Video,300x600,2,1,1,0
finn dallas native sx,728x90,70,178,28,150
mogo marks lal branding (All) platinum sx,320x100,5,12,0,12
sfoc 2018 marks stratford premium sx,160x600,98,450,56,394
ttd family parent sx,160x600,47,179,12,167
/All Apps/Google Play/Games/Music,728x90,1,0,0,0
DO NOT USE,160x600,1,0,0,0
DO NOT USE Microsoft Bin (001),970x250,273,1,1,0
co top 41 converting,970x250,1,0,0,0
mogo marks agg sx xsl37589,970x90,32,39,1,38
mogo marks xsl_ks0001 sx,300x250,14244,47859,4311,43548
ttd food sx,300x250,328,2840,139,2701
/All Apps/Apple App Store/Games/Casino,320x50,69,1,1,0
/All Apps/Apple App Store/News,300x50,7,0,0,0
bbb kpi sx (2019),728x90,2,101,0,101
mogo marks ttd obx kitchen premium sink sx,Unknown,575,35,0,35
mogo marks xsl_74205 sx ,300x50,16,458,18,440
mogo marks xsl_ks0001 sx,160x600,3214,10851,991,9860
mogo marks xsl_ks20780 sx,320x100,133,251,52,199
ttd news sx,970x90,7,2,0,2
/All Apps/Apple App Store/Games/Puzzle,160x600,19,3,2,1
DO NOT USE Mobile - MoPub - Online Communities,300x50,4,0,0,0
DO_NOT_USE Mobile - MoPub - Games,300x600,3,0,0,0
Mogo DBM select video sx,300x250,193,1615,55,1560
Portland Center Stage KPI sx,300x250,0,9,0,9
mogo marks perf arts sx 7,320x100,0,4,0,4
mogo music sx,728x90,26,79,4,75
ttd sports sx,250x250,0,1,0,1
Broadway sx,320x50,0,3,0,3
Duxiana - Longtail Blacklist,970x250,2,0,0,0
mogo education sx,728x90,279,1590,158,1432
mogo marks kpi mdx sx xls9297,970x90,2,4,0,4
mogo marks perf arts sx 5 epx1,970x250,50,195,63,132
mogo sports sx,160x600,40,113,1,112
/All Apps/Apple App Store/Entertainment,160x600,24,3,2,1
DO NOT USE Invite US Expandable Enabled Sites,728x90,165,906,55,851
ttd family parent sx,300x250,1117,2833,332,2501
/All Apps/Apple App Store/Food & Drink,728x90,13,2,1,1
5a local sx seattle,320x50,1,5,1,4
mogo marks agg sx xsl37589,200x200,0,3,0,3
mogo marks lal branding (All) gold sx,300x250,4197,21943,1448,20495
mogo marks perf arts branding high reach sx,336x280,0,1,0,1
mogo marks ticketing sx,160x600,5,91,3,88
ttd male sx,250x250,0,1,0,1
Android Top Selling Free Entertainment,300x600,266,112,92,20
mogo marks sacramento sx,300x50,1,20,6,14
/All Apps/Apple App Store/Games/Strategy,300x250,1,0,0,0
mogo marks pav kpi sx 3,160x600,21,41,2,39
mogo marks xsl_ks20780 sx,250x250,5,22,0,22
DO NOT USE Mobile - MoPub - Arts & Entertainment/Music & Audio,300x250,81,3,3,0
Mogo DBM premium video sx,970x90,4,6,0,6
mogo marks branding drhbx gold sx,320x50,6018,10036,3890,6146
mogo marks branding drhbx platinum sx,300x600,202,1510,95,1415
mogo marks video branding extended reach tail aggregate sx,300x600,3346,10709,1162,9547
ttd male sx,320x100,5,0,0,0
ttd sports sx,320x100,2,9,0,9
/All Apps/Google Play/Games/Arcade,728x90,5,0,0,0
/All Apps/Google Play/Games/Puzzle,300x600,152,37,37,0
mogo marks native medium reach tail aggregate sx,300x250,10329,34828,3079,31749
ttd travel sx,160x600,106,791,41,750
/All Apps/Apple App Store/Social Networking,300x250,28,1,1,0
Channel of Top Global Sites for Nielsen Display Ads - DO NOT EDIT,728x90,7874,37057,2488,34569
Channel of Top non-US Sites for Nielsen Video Ads - DO NOT EDIT,970x250,1470,2842,421,2421
DO NOT USE Tier 1* (CHANNEL),320x50,14384,18622,6107,12515
mogo marks branding comp rate silver video sx,300x250,7717,20861,2242,18619
mogo marks branding drhbx silver sx,300x250,8404,33835,2858,30977
/All Apps/Apple App Store/Games/Dice,728x90,25,1,1,0
/All Apps/Google Play/Lifestyle,300x250,11,2,0,2
DO NOT USE Tier 1* (CHANNEL),200x200,0,1,0,1
mogo marks ballet sx,300x250,4,14,2,12
mogo marks natl elite cat-aff-im sx,160x600,55,389,22,367
mogo marks perf arts gold sx,300x600,27,85,20,65
ttd gaming sx,320x50,843,880,254,626
/All Apps/Google Play/Tools,320x50,119,20,12,8
5a local sx seattle,300x250,1,11,1,10
mogo financial services kpi sx,300x600,559,2722,201,2521
mogo marks branding drhbx platinum sx,300x50,3,121,0,121
sfoc rtx kpi sx,728x90,2,36,0,36
/All Apps/Google Play/Games/Puzzle,300x50,10,0,0,0
DO NOT USE Tier 2* (CHANNEL),160x600,203,876,48,828
maryland-dc sx,970x250,47,20,5,15
mogo marks agg sx xsl37589,120x600,1,0,0,0
mogo marks branding drhbx silver sx,300x50,121,4458,89,4369
/All Apps/Apple App Store,320x50,3438,96,51,45
/All Apps/Google Play/Games/Card,320x50,107,11,10,1
mogo marks jazz & blues sx,300x600,5,31,1,30
mogo mba tier 1 sx,320x50,105,271,58,213
mogo marks lal (purchase) platinum sx,970x90,3,0,0,0
Performing Arts Fort Worth Perf Arts 5 black sx,970x250,0,1,0,1
mogo marks video sx xsl44760 class c,160x600,1409,3919,403,3516
at atlanta sx,320x50,5,16,1,15
mogo marks bay area sx,970x250,4,8,2,6
mogo marks branding tier 1 sx xls37852,970x90,18,21,1,20
mogo marks branding tier 2 sx xls37852,970x250,1343,3249,599,2650
mogo marks lal (purchase) platinum sx,320x100,1,5,0,5
mogo marks perf arts platinum sx,160x600,76,607,29,578
mogo marks san francisco sx,160x600,3,5,1,4
mogo marks xsl66781 sx,970x250,785,2036,383,1653
dbm native sx (adx),970x90,3,3,0,3
mogo marks lal (purchase) gold sx,300x250,3622,17321,1359,15962
Channel of Top US Sites for Nielsen Video Ads - DO NOT EDIT,336x280,32,24,2,22
mogo marks branding elite tier sx xls37852,160x600,82,611,33,578
mogo marks hq100p sx,970x250,1358,2649,487,2162
mogo marks natl canada cat-aff-im sx,970x90,2,4,0,4
mogo marks sacramento sx,300x250,10,24,3,21
pac esports sx,300x600,147,1314,55,1259
sfjazz travel sx,160x600,5,37,4,33
DO NOT USE AppNexus - Collective Media,160x600,469,1239,128,1111
Stratford KPI sx,160x600,0,35,0,35
mogo marks t1 brand sx trim,250x250,1,3,0,3
/All Apps/Google Play/Tools,336x280,3,0,0,0
kid safe sx,728x90,1259,2965,184,2781
DO NOT USE Tier 1,320x100,49,86,19,67
mogo marks video branding medium reach tail aggregate sx,728x90,5580,29340,1968,27372
mogo music sx,160x600,6,20,0,20
sfoc cix sx,728x90,0,4,0,4
ttd music sx,728x90,40,160,7,153
5a kpi sx,320x50,0,3,0,3
Performing Arts Fort Worth sx,728x90,6,84,2,82
mogo marks branding comp rate silver video sx,320x100,42,53,20,33
mogo marks branding drhbx silver sx,320x100,95,199,45,154
mogo marks disney sx,320x50,19,28,6,22
mogo marks video branding max reach tail aggregate sx,300x50,216,5995,161,5834
mogo marks wine sx,300x250,15,128,9,119
Duxiana - Underperformance Blacklist,728x90,40,2,1,1
Mogo DBM select video sx,250x250,0,1,0,1
magic theatre top performing sx,300x250,221,185,116,69
/All Apps/Google Play/Games/Music,300x600,1,0,0,0
finn dallas native sx,300x600,31,65,14,51
mogo marks agg sx xsl37589,728x90,8687,45690,2918,42772
mogo marks branding drhbx platinum sx,728x90,275,1608,107,1501
mogo marks native medium reach tail aggregate sx,320x100,102,146,49,97
mogo marks video branding extended reach tail aggregate sx,970x250,1656,2992,531,2461
ttd gaming sx,336x280,0,1,0,1
/All Apps/Apple App Store/Photo & Video,320x50,157,0,0,0
/All Apps/Google Play/Games/Simulation,728x90,5,0,0,0
Channel of Top non-US Sites for Nielsen Display Ads - DO NOT EDIT,300x250,12667,40567,3337,37230
Channel of Top non-US Sites for Nielsen Video Ads - DO NOT EDIT,320x100,53,97,25,72
Nashville Local sx,970x250,0,11,0,11
education master sx,160x600,591,2826,137,2689
mogo marks natl canada cat-aff-im sx,320x50,365,2566,196,2370
mogo marks seattle sx,728x90,63,111,15,96
dbm native sx (adx),320x50,6109,7277,3984,3293
mogo marks pav kpi sx 2,300x600,725,2716,302,2414
sfoc pslx 2019 sx (Mar_2019),300x600,242,2102,203,1899
ttd tech sx,160x600,302,305,67,238
/All Apps/Apple App Store/Education,320x50,154,5,4,1
Lynn General,160x600,86,372,33,339
ttd weather sx,300x600,392,637,96,541
/All Apps/Google Play/Education,300x600,3,0,0,0
/All Apps/Google Play/Finance,300x600,86,1,1,0
/All Apps/Google Play/Travel & Local,320x50,11,10,0,10
mogo marks branding tier 3 sx xls37852,970x90,14,13,1,12
mogo marks lal branding (All) silver sx,300x50,132,5540,100,5440
mogo marks video sx xsl44760 class a,250x250,0,1,0,1
Android Top Selling Free Business,300x250,5,0,0,0
mogo canada t1 sx,320x100,16,16,11,5
mogo marks branding tier 1 sx xls37852,160x600,3548,15831,1210,14621
sfoc 2018 marks stratford premium sx,300x600,198,1631,181,1450
ttd family parent sx,300x600,32,149,3,146
/All Apps/Apple App Store/Food & Drink,320x50,16,0,0,0
Mogo DBM select video sx,300x600,105,980,48,932
Provident High CTR List ,728x90,6,0,0,0
mogo biz-fi sx,250x250,0,1,0,1
mogo marks branding tier 2 sx xls37852,300x250,7845,30167,2705,27462
mogo marks cincinnati sx,300x50,1,1,0,1
mogo marks xsl66781 sx,300x250,3880,12308,1223,11085
mogo music sx,320x50,72,371,48,323
ttd education sx,160x600,519,2438,122,2316
DO NOT USE AppNexus - Collective Media,250x250,0,1,0,1
DO NOT USE Tier 1* (CHANNEL),300x100,1,0,0,0
mogo marks perf arts sx 7,970x250,24,132,52,80
DO NOT USE Invite US Expandable Enabled Sites,320x50,712,856,190,666
Performing Arts Fort Worth Perf Arts 5 black sx,300x250,1,2,0,2
bbb kpi sx (2019),320x50,11,161,7,154
mogo black sx,728x90,347,1092,80,1012
mogo marks dallas sx,728x90,12,184,4,180
mogo marks native standard reach (no) tail aggregate sx,300x250,8486,29958,2488,27470
mogo marks xsl_ks20780 sx,970x250,2043,3767,684,3083
/All Apps/Google Play/Productivity,300x250,2,0,0,0
DO NOT USE Spanish Language Sites,300x50,1,20,0,20
DO NOT USE Tier 2* (CHANNEL),336x280,1,7,0,7
mogo cult soph sx,320x100,35,40,16,24
mogo education sx,320x50,759,1064,191,873
mogo marks bay area sx,300x250,173,737,102,635
mogo marks hq100p sx,300x250,7342,23680,2263,21417
mogo marks kpi achievers sx,300x50,0,20,0,20
mogo marks lal branding (All) gold sx,300x600,1627,9189,595,8594
mogo marks visual arts sx,300x250,3,3,0,3
/All Apps/Apple App Store/Business,320x50,147,7,5,2
mogo marks natl canada cat-aff-im sx,300x50,0,13,0,13
mogo marks nyc sx,320x100,0,4,0,4
mogo marks perf arts sx 6,300x600,5,43,4,39
mogo marks xsl_800p sx,336x280,4,32,1,31
sfoc stratford hqcat sx,320x50,83,859,51,808
/All Apps/Google Play/Media & Video,300x600,11,3,3,0
mogo marks high intenders sx,970x250,24,123,16,107
mogo marks perf arts sx 11,300x600,5,42,4,38
mogo sf local sx,300x600,83,346,35,311
ttd male sx,160x600,80,180,24,156
/All Apps/Google Play,336x280,8,7,7,0
DO_NOT_USE Mobile - MoPub - Games,728x90,24,1,1,0
Stratford Black RT SX,970x250,2,1,1,0
mogo black sx,970x90,1,1,0,1
mogo marks native (sharethrough) unique us sx,320x50,7636,8680,1970,6710
mogo marks video branding max reach tail aggregate sx,336x280,14,25,3,22
mogo marks xsl_74205 (2p dims) sx ,300x250,5410,15459,1583,13876
sfoc marks kpi sx (062018),970x250,1,41,0,41
zt local austin sx,970x250,9,19,2,17
/All Apps/Apple App Store/Education,300x50,2,0,0,0
DO NOT USE OAM UK,300x250,81,295,10,285
Lynn DMAC,160x600,62,135,27,108
mogo t1 brand sx,300x250,6199,17225,1887,15338
/All Apps/Apple App Store/Newsstand,970x90,1,0,0,0
DSM African American sx,320x50,6,2,0,2
Mogo DBM premium video sx,300x600,1929,5868,666,5202
dbm native sx (adx),300x50,30,428,27,401
/All Apps/Google Play/Games/Role Playing,320x50,16,1,1,0
mogo lydia peacecenter test,300x50,25,539,20,519
mogo marks branding tier 1 sx xls37852,320x50,21054,32446,8373,24073
ttd education sx,728x90,723,3248,277,2971
DO NOT USE Tier 1* (CHANNEL),320x100,49,86,19,67
DO NOT USE Tier 3* (CHANNEL),200x200,0,2,0,2
dbm native sx (adx),970x250,659,637,114,523
mogo marks branding max reach sx,Unknown,575,35,0,35
mogo marks bwwpb sx,300x600,2,36,2,34
mogo marks native (sharethrough) unique us sx,336x280,0,2,0,2
mogo marks xsl_ks0001 sx,320x50,22970,33270,9017,24253
/All Apps/Apple App Store/Education,728x90,33,0,0,0
mogo marks native sx xsl1045 class a,250x250,2,0,0,0
mogo marks natl canada cat-aff-im sx,970x250,501,1436,256,1180
ttd female sx,200x200,0,1,0,1
/All Apps/Apple App Store/Medical,728x90,5,0,0,0
APACTix Sitelist sx,300x250,22,47,0,47
mogo marks native (sharethrough) unique can sx,300x250,1933,6183,503,5680
mogo marks ticketing sx,320x50,6,52,2,50
/All Apps/Google Play/Entertainment,320x50,227,16,9,7
DO NOT USE AppNexus - Collective Media,300x600,1600,3633,463,3170
mogo biz-fi sx,300x600,400,1525,164,1361
mogo marks broadway sx,300x600,5,41,3,38
mogo marks nyt sx,728x90,138,824,48,776
mogo marks stratford (canada) sx,300x600,15,196,20,176
mogo sports sx,320x50,810,870,145,725
/All Apps/Apple App Store/Games/Music,728x90,5,0,0,0
DCPA display local sx,300x250,4,8,1,7
DO NOT USE Mobile - MoPub - Arts & Entertainment/Music & Audio,728x90,4,0,0,0
DO NOT USE Tier 1,728x90,4726,15686,1192,14494
mogo marks rt+ob lt_lq black sx  ,320x50,4,0,0,0
/All Apps,300x250,4392,824,670,154
DO NOT USE Tier 3* (CHANNEL),468x60,0,3,0,3
mogo marks branding drhbx silver sx,728x90,3431,22830,1260,21570
/All Apps/Google Play/Games/Puzzle,320x50,999,147,141,6
mogo marks branding comp rate silver video sx,728x90,2622,8970,844,8126
mogo marks branding drhbx platinum sx,320x50,396,1386,135,1251
mogo marks native medium reach tail aggregate sx,728x90,4384,24370,1462,22908
mogo marks native sx xsl1045 class b,970x90,0,4,0,4
mogo marks video branding extended reach tail aggregate sx,320x50,19111,25039,7794,17245
pac esports sx,970x250,2,2,1,1
/All Apps/Apple App Store/Social Networking,728x90,11,0,0,0
/All Apps/Apple App Store/Travel,320x50,175,3,2,1
/All Apps/Google Play/Books & Reference,300x50,1,4,4,0
Android Top Selling Free Entertainment,320x50,661,40,33,7
DO NOT USE Mobile - MoPub - Arts & Entertainment,300x250,87,4,3,1
DO NOT USE fgu test public channel,300x250,1056,3518,309,3209
mogo canada t1 sx,160x600,111,711,30,681
mogo marks native sx xsl1045 class a,300x50,11,306,6,300
mogo marks perf arts sx 7,160x600,66,529,26,503
/All Apps/Apple App Store/Games/Trivia,320x50,13,0,0,0
mogo marks branding drhbx platinum sx,250x250,0,3,0,3
mogo sf local sx,300x50,4,81,0,81
tz - Local Seattle sx,320x50,9,6,0,6
DO NOT USE Tier 3* (CHANNEL),320x50,10761,14251,3021,11230
Nashville Local sx,728x90,0,5,0,5
arizona opera top converters sx,160x600,4,13,4,9
maryland-dc sx,160x600,3,7,2,5
mogo marks perf arts sx 6,300x50,0,8,0,8
mogo mba tier 2 sx,320x100,1,0,0,0
Android Top Selling Free Music and Audio,300x250,154,12,7,5
DCPA video local sx,300x600,0,3,0,3
Mercury Theater Chicago sx,300x250,55,39,23,16
mogo marks agg sx xsl37589,250x250,6,25,0,25
mogo marks video branding medium reach tail aggregate sx,250x250,6,11,0,11
ttd female sx,320x50,1608,3632,522,3110
ttd music sx,250x250,0,1,0,1
Android Top Selling Free Sports,320x50,198,13,7,6
Channel of Top Global Sites for Nielsen Display Ads - DO NOT EDIT,160x600,5188,21192,1621,19571
Channel of Top US Sites for Nielsen Video Ads - DO NOT EDIT,970x90,18,25,0,25
debartolo local site list,728x90,0,7,0,7
dso custom hx,320x50,12,359,12,347
fgu test public channel,300x250,1056,3518,309,3209
mogo marks ttd obx kitchen premium sink sx,300x50,141,4205,135,4070
mogo marks xsl_74205 (2p dims) sx ,300x50,16,453,18,435
ttd entertainment sx,320x50,5066,7795,1557,6238
/All Apps/Google Play/Games,300x250,265,36,34,2
kid safe sx,250x250,1,1,0,1
mogo marks houston sx,160x600,0,2,0,2
mogo marks native (sharethrough) unique us sx,200x200,0,1,0,1
mogo marks native sx xsl1045 class c,970x90,1,7,0,7
mogo marks xsl_74205 (4p dims) sx ,300x250,3050,9039,966,8073
/All Apps/Apple App Store,728x90,3327,275,252,23
Lynn Grad,160x600,62,135,27,108
mogo marks video branding extended reach tail aggregate sx,300x50,107,3681,87,3594
mogo marks xsl66781 sx,970x90,2,4,0,4
/All Apps/Apple App Store/Travel,300x50,10,0,0,0
/All Apps/Google Play/Games/Card,728x90,23,3,3,0
Android Top Selling Free Entertainment,300x50,11,0,0,0
Diablo Blacklist ,160x600,0,22,0,22
ttd gaming sx,728x90,463,806,164,642
Channel of Top non-US Sites for Nielsen Display Ads - DO NOT EDIT,300x50,134,3981,118,3863
Duxiana - KPI sx,160x600,71,3,2,1
mogo financial services kpi sx,300x250,3402,10800,870,9930
mogo marks branding elite tier sx xls37852,300x600,81,515,42,473
mogo marks native high reach tail aggregate sx,300x600,3765,15457,1357,14100
mogo marks video sx xsl44760 class c,300x600,2580,7512,911,6601
mogo marks xsl_74205 (2p dims) sx ,320x50,4583,6556,1280,5276
mogo mba tier 2 sx,336x280,0,1,0,1
sfoc pslx 2018 sx (Jun_2018),970x250,73,377,64,313
/All Apps/Google Play/Communication,300x600,12,0,0,0
/All Apps/Google Play/Games/Adventure,728x90,2,0,0,0
/All Apps/Google Play/Transportation,320x50,17,4,4,0
/All Apps/Google Play/Transportation,728x90,1,0,0,0
Channel of Top US Sites for Nielsen Display Ads - DO NOT EDIT,970x90,26,29,0,29
mogo marks san francisco sx,300x600,71,298,31,267
mogo t1 brand sx,320x50,9042,11256,4610,6646
/All Apps/Google Play/Tools,728x90,1,0,0,0
Stratford KPI sx,300x600,1,3,0,3
mogo marks native standard reach (no) tail aggregate sx,970x90,11,13,0,13
mogo marks natl cat-aff-im sx,300x600,1130,3938,459,3479
at atlanta sx,300x250,4,58,3,55
mogo black rt sx,320x50,6,2,0,2
mogo marks lal branding (All) silver sx,468x60,0,3,0,3
mogo marks xsl_800p sx,320x50,22135,33937,8593,25344
mogo music sx,320x100,1,0,0,0
DO NOT USE Invite US Expandable Enabled Sites,320x100,0,3,0,3
Nashville Local sx,300x600,2,53,6,47
mogo marks branding drhbx silver sx,336x280,3,17,1,16
mogo marks video branding max reach tail aggregate sx,320x50,28817,38440,10510,27930
mogo mba tier 2 sx,300x250,1566,3558,484,3074
/All Apps/Apple App Store/Weather,728x90,82,2,2,0
Channel of Top Global Sites for Nielsen Display Ads - DO NOT EDIT,250x250,9,21,0,21
Mogo DBM premium video sx,Unknown,575,35,0,35
mogo education sx,320x100,19,17,7,10
mogo marks classical music sx,160x600,2,13,2,11
mogo marks high intenders sx,300x50,0,23,0,23
mogo marks los angeles sx,300x50,0,5,0,5
/All Apps/Apple App Store/Games/Casino,970x250,17,0,0,0
/All Apps/Google Play,320x50,6717,742,512,230
mogo marks branding comp rate silver video sx,336x280,0,1,0,1
mogo marks native medium reach tail aggregate sx,336x280,6,17,3,14
sfoc kpi sx (acquisition 2019),320x50,107,490,77,413
Android Top Selling Free News and Magazines,300x50,5,0,0,0
Greg's GG KPI + relevant sites list,300x600,3,2,1,1
ttd beauty sx,300x250,45,200,6,194
/All Apps/Google Play/Games/Casual,336x280,2,0,0,0
/All Apps/Google Play/Games/Racing,300x600,11,0,0,0
mogo sf local sx,300x250,216,789,123,666
DCPA rt black sx,970x250,1,1,1,0
DO NOT USE Invite US Expandable Enabled Sites,970x90,2,2,0,2
Duxiana- Bad Site List(Allan) ,728x90,7,0,0,0
mogo marks bw-theatre sx,160x600,2,19,2,17
mogo marks lal branding (All) platinum sx,336x280,1,7,0,7
/All Apps/Apple App Store/Business,728x90,65,3,0,3
Chicago T1 sites,300x600,9,6,3,3
DO NOT USE Invite December Brand Safe List,320x50,15622,21122,6502,14620
mogo marks classical music sx,300x600,0,1,0,1
mogo marks lal (purchase) silver sx,336x280,2,17,0,17
mogo marks native (sharethrough) unique us sx,728x90,1010,6476,319,6157
mogo marks perf arts sx 6,300x250,312,1394,137,1257
mogo education sx,970x90,2,3,0,3
mogo marks high intenders sx,320x100,15,64,9,55
mogo marks video sx xsl44760 class b,970x250,554,542,107,435
/All Apps/Google Play/Media & Video,300x250,2,0,0,0
Channel of Top non-US Sites for Nielsen Video Ads - DO NOT EDIT,160x600,1830,6668,486,6182
DO NOT USE Rubicon,320x50,191,448,68,380
DO NOT USE Tier 3 (2),336x280,0,6,0,6
mogo marks pav kpi sx,320x50,358,979,121,858
mogo marks perf arts sx 11,300x250,288,1330,128,1202
mogo marks shakespeare sx,728x90,4,13,1,12
mogo marks ttd obx kitchen premium sink sx,300x250,14057,47342,4261,43081
sfoc stratford hqcat sx,728x90,17,206,15,191
ttd kids sx,320x50,526,469,116,353
/All Apps/Apple App Store/Business,300x50,2,0,0,0
/All Apps/Apple App Store/Games/Role Playing,728x90,13,2,2,0
mogo marks lal branding (All) platinum sx,970x250,183,553,90,463
mogo marks native standard reach (no) tail aggregate sx,468x60,0,1,0,1
mogo marks opera sx,160x600,2,11,1,10
ttd auto sx,970x90,1,0,0,0
ttd entertainment sx,300x250,3221,8952,1019,7933
/All Apps/Apple App Store/Newsstand/News & Politics,300x250,283,15,7,8
/All Apps/Google Play/Games/Casual,728x90,18,2,2,0
ttd female sx,300x250,656,3488,193,3295
/All Apps/Google Play/Sports,300x600,3,0,0,0
DO NOT USE Invite December Brand Safe List,300x50,100,3040,85,2955
DO NOT USE Tier 3* (CHANNEL),300x250,3768,14058,1095,12963
mogo marks denver sx,970x250,3,11,4,7
mogo marks kpi mdx sx xls9297,320x50,1713,4839,618,4221
mogo marks lal (purchase) silver sx,728x90,3648,22127,1063,21064
mogo marks native (sharethrough) unique us sx,300x50,32,895,20,875
Pac Fox Atlanta EXCLUSION List,970x250,23,20,5,15
allan- UOC  high click rate /  converter list ,728x90,0,4,0,4
dso custom hx,300x250,1,61,1,60
/All Apps/Apple App Store/Games/Trivia,300x250,1,0,0,0
/All Apps/Apple App Store/Reference,300x600,17,0,0,0
Android Top Selling Free Game,320x50,4237,671,619,52
Android Top Selling Free Game,728x90,99,15,14,1
Android Top Selling Free Photography,970x250,1,1,1,0
DO NOT USE Tier 3 (2),970x250,5,13,1,12
mogo centro sx US (2014),300x600,416,901,147,754
mogo marks xsl_800p sx,320x100,104,190,47,143
/All Apps/Apple App Store,320x100,1,0,0,0
/All Apps/Google Play/Music & Audio,300x250,147,7,3,4
/All Apps/Apple App Store/Utilities,300x600,7,1,1,0
DO NOT USE Mobile - MoPub - Beauty & Fitness/Fitness,320x50,5,1,1,0
DO NOT USE OAM UK,728x90,20,74,4,70
mogo marks denver sx,300x250,81,313,38,275
mogo marks native (sharethrough) unique can sx,300x50,31,783,19,764
ttd gaming sx,320x100,4,0,0,0
Android Top Selling Free Weather,320x50,1315,367,287,80
BR Native sx,300x600,11,42,1,41
Brandcast Blacklist ,300x250,1682,6980,459,6521
GG KPI sx,300x600,7,2,0,2
mogo marks video branding max reach tail aggregate sx,250x250,6,12,0,12
mogo marks xsl_74205 (2p dims) sx ,728x90,1231,3868,205,3663
/All Apps/Google Play/News & Magazines,300x600,21,4,4,0
mogo marks branding tier 1 sx xls37852,200x200,0,2,0,2
mogo marks coupon sx,320x50,6,14,1,13
mogo marks ttd obx kitchen premium sink sx,970x250,1891,3384,639,2745
ttd travel sx,300x600,472,908,114,794
/All Apps/Apple App Store/Navigation,300x250,1,0,0,0
Mogo DBM basic video sx,160x600,20,138,7,131
dso kpi audx sx,300x600,0,13,2,11
mogo marks lal branding (All) silver sx,320x50,14909,25109,6409,18700
mogo marks natl cat-aff-im sx,300x50,9,229,6,223
mogo marks outbound kpi sx x1a,728x90,288,1321,93,1228
mogo marks pav kpi sx 3,300x600,87,585,38,547
mogo perf arts sx,320x50,244,901,96,805
mogo t1 brand sx,970x250,1232,2097,393,1704
/All Apps/Apple App Store/Entertainment,300x50,21,0,0,0
/All Apps/Google Play/Entertainment,300x50,1,0,0,0
mogo marks kpi mdx sx xls9297,336x280,0,2,0,2
mogo marks playbill 5 sx x9z,728x90,16,103,10,93
Channel of Top non-US Sites for Nielsen Display Ads - DO NOT EDIT,250x250,6,8,0,8
DO NOT USE Tier 2,300x250,1414,7100,401,6699
Fan Extender IMG/Sidearm Blacklist,320x50,6,3,3,0
mogo canada t1 sx,320x50,4958,7858,3617,4241
mogo marks branding tier 3 sx xls37852,300x600,1472,6195,517,5678
mogo marks pav kpi sx,970x250,51,185,61,124
ttd kids sx,728x90,198,529,120,409
/All Apps/Apple App Store/Games/Puzzle,300x50,13,0,0,0
/All Apps/Apple App Store/Games/Word,300x600,1583,242,234,8
DO NOT USE Invite December Brand Safe List,728x90,3440,13379,1104,12275
DO NOT USE Mobile - MoPub - Computers & Electronics/Software/Multimedia Software/Audio & Music Software,728x90,4,0,0,0
DO NOT USE Tier 1* (CHANNEL),160x600,1040,7786,398,7388
mogo cult soph sx,320x50,5779,7082,3793,3289
mogo marks phoenix sx,320x50,81,149,40,109
mogo sports sx,300x50,19,72,7,65
/All Apps/Apple App Store/Games/Adventure,728x90,3,0,0,0
/All Apps/Google Play/Games/Action,300x250,35,6,6,0
DO NOT USE Rubicon,970x250,2,7,2,5
PAC Singapore sx,300x600,12,12,2,10
mogo lydia peacecenter test,250x250,0,4,0,4
mogo marks branding comp rate gold video sx,300x250,6638,17499,1944,15555
/All Apps/Apple App Store/Games/Educational,300x600,4,0,0,0
mogo marks branding drhbx gold sx,160x600,292,2059,84,1975
mogo marks t1 brand kpi sx x8t,320x50,692,2907,273,2634
/All Apps,336x280,8,7,7,0
/All Apps/Google Play/Photography,320x50,90,5,5,0
fgu test public channel,300x600,9,14,3,11
mogo marks xsl_74205 (4p dims) sx ,300x600,632,3434,283,3151
ttd health sx,970x90,2,2,0,2
/All Apps/Google Play/Games/Casino,320x50,10,5,4,1
Belmont Sitelist v1,300x250,47,147,34,113
Duxiana Broadcast blacklist,728x90,1,0,0,0
Mercury Theater Chicago sx,300x600,15,22,11,11
Western Black sx,300x250,19,917,12,905
mogo marks sports sx,728x90,234,795,31,764
/All Apps/Google Play/Games,300x600,742,207,190,17
mogo mba tier 2 sx,970x250,503,1147,205,942
/All Apps/Google Play/Games/Card,300x50,1,0,0,0
mogo marks lal branding (All) gold sx,320x100,23,81,4,77
mogo t1 brand sx,300x50,51,766,40,726
ttd beauty sx,970x250,4,3,0,3
ttd gaming sx,300x50,5,190,4,186
/All Apps/Apple App Store,300x50,49,2,0,2
DO NOT USE OAM UK,300x50,0,29,0,29
mogo marks natl cat-aff-im sx 3,300x250,2023,5787,701,5086
mogo mba tier 1 sx,300x50,5,89,2,87
DO NOT USE Tier 2* (CHANNEL),320x50,2504,4418,672,3746
DSM African American sx,160x600,0,1,0,1
Performing Arts Fort Worth Test List,970x250,8,10,6,4
mogo marks dallas sx,300x50,0,7,0,7
mogo marks kpi mdx sx xls9297,320x100,7,22,1,21
mogo marks perf arts sx 2,300x250,1628,3983,569,3414
ttd real estate sx,728x90,2,23,1,22
/All Apps/Apple App Store/Finance,728x90,15,0,0,0
RCU Blacklist Sites (CPA),300x600,0,1,0,1
mogo marks lal branding (All) gold sx,468x60,0,3,0,3
mogo marks travel sx,300x600,18,133,1,132
mogo marks wsj sx x4v,728x90,7,17,4,13
ttd music sx,970x90,1,0,0,0
Lynn Grad,320x50,16,51,6,45
mogo canada t1 sx,300x50,5,112,5,107
mogo marks native sx xsl1045 class b,336x280,1,0,0,0
pac motorsports sx,300x250,1053,3018,305,2713
Android Top Selling Free Social,320x50,2352,99,79,20
mogo marks natl elite cat-aff-im sx,728x90,244,2151,92,2059
mogo marks perf arts platinum sx,336x280,0,1,0,1
ttd news sx,728x90,1567,6036,637,5399
mogo marks branding comp rate platinum video sx,300x250,5423,13259,1598,11661
mogo marks perf arts sx 7,300x50,1,26,1,25
mogo marks video branding medium reach tail aggregate sx,970x90,21,22,0,22
mogo marks nyc sx,300x250,1271,2283,414,1869
mogo marks perf arts sx 2,160x600,87,677,34,643
sfoc marks kpi sx (062018),300x600,15,260,21,239
Duxiana - Longtail Blacklist,728x90,18,1,0,1
mogo marks ballet sx,728x90,5,10,3,7
mogo marks high intenders sx,300x600,116,619,67,552
mogo marks lal (purchase) gold sx,336x280,1,11,0,11
pac canada sports sx,320x100,2,9,0,9
sfoc 2018 marks stratford premium sx,300x250,234,2861,206,2655
ttd food sx,160x600,23,310,5,305
DO NOT USE,300x250,1,0,0,0
DO NOT USE OAM FR,320x100,0,4,0,4
mogo marks branding comp rate silver video sx,200x200,0,1,0,1
mogo marks branding drhbx silver sx,200x200,0,3,0,3
mogo marks pav kpi hx,160x600,119,461,32,429
zt local austin sx,300x600,1,1,0,1
/All Apps,300x50,160,10,4,6
/All Apps/Google Play/Lifestyle,320x50,77,5,3,2
DO NOT USE Tier 3,320x100,63,146,24,122
DO NOT USE Tier 3* (CHANNEL) (2),300x50,5,181,4,177
mogo marks native medium reach tail aggregate sx,200x200,0,2,0,2
mogo marks video sx xsl44760 class a,728x90,856,575,62,513
pac motorsports sx,160x600,5,1,0,1
ttd shopping sx,320x100,1,1,0,1
/All Apps/Apple App Store/Games/Action,300x600,8,0,0,0
/All Apps/Apple App Store/Games/Card,320x50,108,1,1,0
Android Top Selling Free News and Magazines,300x600,28,5,2,3
DO NOT USE Tier 1,200x200,0,1,0,1
Portland Center Stage Perf Arts 5 black sx,300x600,1,0,0,0
SP News Black sx,728x90,10,79,8,71
mogo marks los angeles sx,300x250,50,57,12,45
mogo marks wedding sx,160x600,0,2,0,2
Mogo DBM basic video sx,970x250,34,20,4,16
mogo marks lal (purchase) platinum sx,250x250,0,1,0,1
mogo marks native standard reach (no) tail aggregate sx,250x250,4,5,0,5
mogo marks perf arts sx 5 epx1,320x50,237,1124,112,1012
/All Apps/Apple App Store/News,300x600,254,2,1,1
Brandcast Blacklist ,970x90,0,1,0,1
DO NOT USE Mobile - MoPub - Online Communities,300x600,4,1,1,0
DO NOT USE Tier 3* (CHANNEL),160x600,1766,6723,429,6294
NYPR whitelist sx (Advertiser Level),300x600,0,6,0,6
mogo centro sx US (2014),160x600,96,371,29,342
mogo marks branding increased reach sx,336x280,23,65,5,60
Pac Private Events/Wedding sx,300x600,4,31,0,31
mogo marks t1 brand sx trim,320x100,39,66,11,55
/All Apps,300x600,5959,928,859,69
Cal Perf KPI sx ,728x90,19,21,0,21
ttd auto sx,970x250,1,3,0,3
ttd shopping sx,728x90,179,969,53,916
ttd tech sx,336x280,0,6,0,6
Channel of Top Global Sites for Nielsen Video Ads - DO NOT EDIT,970x250,1815,3371,566,2805
DO NOT USE Spanish Language Sites,300x250,54,284,8,276
LSSU url v1,728x90,5,93,2,91
education master sx,336x280,2,2,1,1
mogo marks kpi achievers sx,300x250,1576,3978,543,3435
at atlanta sx,300x600,0,1,0,1
mogo marks t1 brand sx trim,336x280,2,2,1,1
mogo marks travel sx,320x50,133,460,25,435
mogo marks xsl_ks20780 sx,200x200,0,3,0,3
/All Apps/Apple App Store/Newsstand,728x90,97,5,1,4
mogo black sx,970x250,14,21,6,15
mogo centro sx US (2014),320x100,44,38,16,22
mogo marks branding tier 3 sx xls37852,300x50,39,1775,41,1734
mogo marks native sx xsl1045 class b,250x250,2,0,0,0
mogo marks perf arts sx 6,160x600,77,581,30,551
mogo marks ttd obx kitchen premium sink sx,160x600,3162,10747,963,9784
pac motorsports sx,728x90,246,1001,44,957
Provident High CTR List ,970x250,1,0,0,0
mogo marks t1 brand kpi sx x8t,320x100,12,21,7,14
/All Apps/Apple App Store/Games/Word,300x50,1,0,0,0
/All Apps/Google Play/Social,300x250,120,18,14,4
ttd spanish sx,300x50,0,22,3,19
/All Apps/Google Play/Weather,728x90,11,0,0,0
DO NOT USE OAM FR,728x90,0,1,0,1
DO NOT USE Tier 1* (CHANNEL),Unknown,575,35,0,35
DO NOT USE Tier 1* (CHANNEL),468x60,0,1,0,1
LSSU url v1,320x50,184,263,90,173
Performing Arts Fort Worth Top sx,970x250,7,9,2,7
mogo marks travel sx,300x50,0,2,0,2
pac canada sports sx,320x50,1101,1504,233,1271
mogo marks branding comp rate platinum video sx,300x50,2,91,2,89
mogo marks chicago sx,300x250,60,225,20,205
mogo marks elite kpi achievers sx,320x100,15,16,7,9
pac canada sports sx,728x90,344,2268,71,2197
Channel of Top non-US Sites for Nielsen Video Ads - DO NOT EDIT,300x100,1,0,0,0
DO NOT USE Tier 3,320x50,10761,14251,3021,11230
mogo marks broadwayworld sx,728x90,13,25,2,23
ttd entertainment sx,160x600,362,1279,110,1169
ttd shopping sx,320x50,231,683,52,631
DO NOT USE Spanish Language Sites,300x600,2,1,1,0
mogo marks kpi achievers sx,300x600,364,554,116,438
mogo marks xsl_74205 sx ,300x600,1197,5151,483,4668
Android Top Selling Free Travel and Local,320x50,13,0,0,0
DO NOT USE Tier 3,728x90,2235,12499,865,11634
dso custom hx,160x600,0,8,0,8
mogo marks cincinnati sx,300x250,15,49,6,43
mogo marks t1 brand sx trim,970x250,1208,2066,384,1682
mogo t1 brand sx,200x200,0,1,0,1
sfoc hqcat black hx,970x250,1,2,0,2
/All Apps/Google Play/Music & Audio,300x50,3,0,0,0
Android Top Selling Free Entertainment,728x90,45,7,6,1
Android Top Selling Free Game,300x600,1051,245,220,25
Seattle Local sx,300x250,17,12,0,12
/All Apps/Google Play/Games/Puzzle,728x90,24,1,1,0
Android Top Selling Free Tools,320x50,40,6,6,0
mogo marks kpi mdx sx xls9297,300x600,580,2682,261,2421
mogo marks natl cat-aff-im sx 3,970x250,551,1499,294,1205
/All Apps/Apple App Store/Sports,300x50,1,0,0,0
/All Apps/Apple App Store/Travel,728x90,16,1,1,0
Belmont Sitelist v1,728x90,65,271,138,133
Brandcast Blacklist ,300x50,16,1142,16,1126
Western Black sx,970x250,5,46,2,44
mogo lydia peacecenter test,320x50,8594,9542,4509,5033
mogo marks xsl_ks20780 sx,160x600,4530,19264,1388,17876
Channel of Top non-US Sites for Nielsen Display Ads - DO NOT EDIT,320x50,19015,26948,7277,19671
mogo marks perf arts sx 5 epx1,160x600,83,685,33,652
mogo marks video branding extended reach tail aggregate sx,728x90,4445,22247,1536,20711
/All Apps/Apple App Store/Health & Fitness,300x600,1,0,0,0
/All Apps/Google Play/Games/Card,160x600,1,0,0,0
/All Apps/Google Play/Games/Role Playing,728x90,5,0,0,0
Arvada local sx,320x50,5,16,0,16
mogo marks branding increased reach sx,300x100,1,0,0,0
mogo marks branding tier 1 sx xls37852,728x90,5291,26654,1588,25066
mogo marks pav kpi sx,336x280,0,1,0,1
mogo marks perf arts sx 2,970x250,477,1185,241,944
mogo marks ticketing sx,728x90,9,126,4,122
mogo mba tier 1 sx,160x600,0,2,0,2
mogo t1 brand sx,160x600,497,1661,148,1513
/All Apps/Apple App Store/Entertainment,320x50,1569,47,25,22
/All Apps/Apple App Store/Games/Arcade,728x90,12,1,1,0
Android Top Selling Free Education,320x50,43,1,1,0
DO NOT USE OAM UK,160x600,41,284,11,273
mogo marks xsl_ks0001 sx,728x90,5979,25460,1831,23629
mogo sports sx,728x90,246,945,38,907
ttd food sx,970x250,21,87,10,77
Channel of Top US Sites for Nielsen Display Ads - DO NOT EDIT,120x600,1,0,0,0
DO NOT USE AppNexus - Collective Media,300x250,3085,9978,1006,8972
DO NOT USE Mobile - MoPub - People & Society,320x50,27,1,1,0
dbm native sx (adx),320x100,21,35,16,19
mogo marks bwwpb sx,300x250,274,1272,124,1148
mogo marks lal (purchase) platinum sx,300x50,6,366,2,364
sfjazz travel sx,300x250,12,26,2,24
sfoc pslx 2018 sx (Jun_2018_Archived),300x600,218,1788,196,1592
ttd male sx,300x600,293,1059,94,965
/All Apps/Apple App Store/Games/Puzzle,320x50,589,30,16,14
/All Apps/Apple App Store/Games/Simulation,320x50,15,0,0,0
Brandcast Blacklist ,250x250,0,2,0,2
mogo biz-fi sx,300x250,1896,4180,596,3584
mogo marks broadway sx,300x250,319,1388,141,1247
mogo marks natl canada cat-aff-im sx,320x100,0,4,0,4
mogo marks perf arts platinum sx,300x250,334,1655,159,1496
mogo marks stratford (canada) sx,300x250,2,116,1,115
ttd health sx,320x50,816,3245,297,2948
ttd sports sx,300x600,92,272,30,242
/All Apps/Apple App Store/Utilities,320x50,191,8,5,3
/All Apps/Apple App Store/Utilities,728x90,80,2,0,2
Cal Perf KPI sx ,300x600,30,7,0,7
mogo marks pav kpi sx 3,728x90,196,1547,81,1466
mogo marks perf arts platinum sx,970x250,47,182,61,121
ttd shopping sx,300x600,30,161,14,147
Android Top Selling Free Social,300x50,50,0,0,0
DO NOT USE Tier 3,300x600,1118,5317,325,4992
mogo marks native sx xsl1045 class b,970x250,414,241,23,218
mogo marks playbill sx x3e,970x250,9,44,5,39
mogo marks video branding max reach tail aggregate sx,160x600,4166,17215,1300,15915
BR Native sx,728x90,2,23,0,23
DO NOT USE Mobile - MoPub - Arts & Entertainment/Entertainment Industry/Recording Industry,728x90,4,0,0,0
DO NOT USE OAM FR,300x600,0,6,0,6
mogo marks broadwayworld sx,300x250,135,683,65,618
provident shortlist ,200x200,0,1,0,1
/All Apps/Google Play/Weather,300x250,12,4,1,3
dso kpi audx sx,728x90,0,19,0,19
mogo marks broadway sx,970x250,24,130,52,78
mogo marks natl cat-aff-im sx,320x100,12,21,7,14
mogo marks natl elite cat-aff-im sx,300x50,5,85,2,83
Cal Performances Perf Arts 5 5 black sx,300x250,8,2,0,2
DO NOT USE Tier 2* (CHANNEL),300x50,27,1810,17,1793
DO NOT USE Tier 3* (CHANNEL),250x250,0,9,0,9
GG KPI sx,728x90,5,12,0,12
mogo marks branding elite tier sx xls37852,320x100,1,12,0,12
mogo marks native high reach tail aggregate sx,320x100,117,182,50,132
mogo marks video sx xsl44760 class c,320x100,71,101,28,73
DO NOT USE Microsoft Bin (001),300x600,37,19,1,18
allan- UOC  high click rate /  converter list ,300x250,0,8,0,8
co top 41 converting,300x600,4,9,0,9
fgu test public channel,320x50,29,43,3,40
mogo marks xsl_74205 (2p dims) sx ,970x250,1059,2046,389,1657
ttd sports sx,970x90,1,2,0,2
/All Apps/Apple App Store/Games/Role Playing,300x250,1,0,0,0
Android Top Selling Free Music and Audio,320x50,401,25,13,12
Mercury Theater Chicago sx,320x50,19,26,10,16
mogo marks lal (purchase) silver sx,300x250,9386,39782,3000,36782
mogo marks lal branding (All) platinum sx,300x250,933,5667,377,5290
mogo marks ttd obx kitchen premium sink sx,200x200,0,3,0,3
sfoc hqcat black hx,728x90,0,2,0,2
Android Top Selling Free Photography,300x250,90,26,23,3
Western Black sx,728x90,18,425,3,422
mogo marks xsl_74205 (4p dims) sx ,320x50,1901,4857,653,4204
ttd male sx,970x90,1,2,0,2
/All Apps/Google Play/Games/Board,300x600,8,0,0,0
Android Movers and Shakers,300x250,100,34,31,3
Android Top Selling Free Music and Audio,728x90,3,0,0,0
Cal Perf KPI sx ,160x600,4,1,0,1
ttd auto sx,160x600,4,12,0,12
ttd shopping sx,160x600,24,164,3,161
/All Apps/Google Play/Games,320x50,1674,274,235,39
DO NOT USE OAM UK,970x250,42,55,11,44
DO NOT USE Tier 3 (2),300x250,295,1922,104,1818
LSSU url v1,160x600,1,56,1,55
Pac Private Events/Wedding sx,250x250,0,1,0,1
mogo marks native high reach tail aggregate sx,300x50,200,5660,157,5503
mogo marks outbound kpi sx x1a,970x250,534,1267,251,1016
mogo marks perf arts gold sx,300x50,0,7,0,7
mogo marks video branding max reach tail aggregate sx,300x250,16195,53801,4739,49062
Android Top Selling Free Books and Reference,300x600,47,10,9,1
DO NOT USE AppNexus - Collective Media,200x200,0,1,0,1
PAC Singapore Rugby sx,320x50,2,13,0,13
Performing Arts Fort Worth Test List,320x50,2,33,3,30
iab aff-im black sx,320x50,2,1,0,1
mogo marks perf arts sx 5 rx1,336x280,0,1,0,1
mogo marks perf arts sx 7,300x600,9,69,3,66
mogo marks phoenix sx,300x250,140,183,60,123
/All Apps/Apple App Store/Games/Adventure,300x250,1,0,0,0
/All Apps/Google Play/Games/Strategy,320x50,10,0,0,0
Performing Arts Fort Worth Test List,728x90,1,25,0,25
gostanford.com,728x90,0,1,0,1
magic theatre top performing sx,160x600,2,14,2,12
mogo marks natl cat-aff-im sx 3,970x90,2,4,0,4
mogo marks pav kpi sx 2,336x280,0,2,0,2
mogo marks t1 brand kpi sx x8t,300x250,3809,10147,1228,8919
/All Apps/Google Play/Games/Board,728x90,6,1,1,0
Channel of Top US Sites for Nielsen Video Ads - DO NOT EDIT,300x100,1,0,0,0
DO NOT USE Tier 1,970x90,11,12,1,11
dso kpi audx sx,970x250,0,29,0,29
mogo cult soph sx,300x250,3274,8779,1010,7769
ttd travel sx,728x90,417,1212,72,1140
BR Native sx,970x250,23,51,8,43
GG KPI sx,970x250,1,1,1,0
mogo marks xsl_ks20780 sx,300x600,5479,22594,2012,20582
DO NOT USE Tier 2,970x250,74,77,11,66
Performing Arts Fort Worth Test List,300x250,19,101,12,89
iab aff-im black sx,300x250,5,2,0,2
mogo marks branding drhbx platinum sx,160x600,72,431,14,417
mogo marks lal branding (All) silver sx,320x100,77,155,33,122
/All Apps/Google Play/Games/Strategy,300x250,1,0,0,0
DCPA video local sx,728x90,4,60,2,58
PAC Singapore Rugby sx,300x250,10,12,0,12
mogo marks branding increased reach sx,300x600,6031,24264,2142,22122
mogo marks native sx xsl1045 class b,300x50,13,378,6,372
mogo marks playbill sx x3e,300x50,0,2,0,2
mogo marks branding comp rate gold video sx,970x250,1232,2041,356,1685
mogo marks lal (purchase) platinum sx,320x50,3710,5532,3240,2292
mogo marks perf arts sx 2,336x280,0,1,0,1
mogo perf arts sx,320x100,1,4,0,4
ttd tech sx,300x600,164,604,32,572
DO NOT USE Microsoft Bin (001),300x250,1404,3196,331,2865
mogo marks branding drhbx gold sx,970x90,10,13,1,12
mogo marks sports sx,970x90,1,4,0,4
mogo marks video branding medium reach tail aggregate sx,160x600,3835,15918,1212,14706
ttd music sx,160x600,312,1053,70,983
Android Top Selling Free Weather,320x100,1,3,3,0
Chicago T1 sites,970x250,58,93,44,49
education master sx,300x600,628,2900,216,2684
mogo marks native standard reach (no) tail aggregate sx,320x50,18177,24330,7638,16692
/All Apps,320x50,10151,838,563,275
Channel of Top non-US Sites for Nielsen Display Ads - DO NOT EDIT,468x60,0,1,0,1
DO NOT USE Mobile - MoPub - Online Communities,320x50,84,3,1,2
NYPR whitelist sx (Advertiser Level),320x50,0,3,0,3
mogo marks branding increased reach sx,250x250,6,24,0,24
mogo marks email sx,160x600,1365,3220,517,2703
mogo marks native sx xsl1045 class c,970x250,523,491,51,440
/All Apps/Apple App Store/News,320x50,887,37,19,18
/All Apps/Google Play/Games/Simulation,300x600,49,3,3,0
Pac Private Events/Wedding sx,320x50,18,72,5,67
mogo marks branding drhbx gold sx,300x250,2760,10996,947,10049
mogo marks xsl_74205 sx ,320x50,4648,6857,1332,5525
ttd finance sx,970x250,668,1421,290,1131
Channel of Top Global Sites for Nielsen Display Ads - DO NOT EDIT,300x250,18903,61075,5032,56043
DO NOT USE Spanish Language Sites,728x90,19,45,9,36
education master sx,250x250,0,1,0,1
mogo marks kpi achievers sx,728x90,288,1321,93,1228
/All Apps/Google Play/Games/Word,970x250,1,1,1,0
Pac Private Events/Wedding sx,728x90,2,32,0,32
dbm video sx,970x250,1278,2409,418,1991
mogo marks lal (purchase) platinum sx,160x600,131,1152,46,1106
mogo marks xsl_74205 sx ,728x90,1247,4074,226,3848
ttd kids sx,970x90,0,1,0,1
/All Apps/Apple App Store/Games/Sports,300x600,7,1,1,0
Channel of Top US Sites for Nielsen Video Ads - DO NOT EDIT,320x100,110,237,42,195
DO NOT USE Tier 3* (CHANNEL) (2),970x250,5,13,1,12
mogo marks opera sx,728x90,1,1,0,1
mogo marks seattle sx,300x600,15,17,4,13
ttd tech sx,250x250,1,0,0,0
Belmont Sitelist v1,300x600,228,479,192,287
DO NOT USE Tier 1,300x250,9630,31392,2999,28393
DO NOT USE Tier 3,250x250,0,9,0,9
Western Black sx,300x600,7,549,4,545
/All Apps/Google Play/Tools,300x50,6,0,0,0
Duxiana Broadcast blacklist,320x50,2,0,0,0
mogo marks natl cat-aff-im sx 3,300x600,317,1493,147,1346
mogo marks sports sx,320x50,814,902,147,755
Android Top Selling Free Music and Audio,300x600,71,12,11,1
Channel of Top non-US Sites for Nielsen Video Ads - DO NOT EDIT,728x90,3503,14226,913,13313
mogo marks kpi achievers sx,336x280,0,1,0,1
mogo marks playbill sx x3e,160x600,7,22,0,22
mogo sports sx,970x90,1,1,0,1
/All Apps/Apple App Store/Shopping,728x90,1,0,0,0
/All Apps/Google Play/Games/Trivia,300x50,1,0,0,0
BBB perf arts 5 black sx,320x50,8,49,3,46
mogo marks lal branding (All) gold sx,970x250,841,2230,364,1866
mogo marks perf arts silver sx,320x50,328,1372,135,1237
mogo marks perf arts silver sx,728x90,78,593,30,563
mogo marks xsl_74205 sx ,336x280,0,2,0,2
ttd family parent sx,200x200,0,1,0,1
DO NOT USE Mobile - MoPub - Games/Computer & Video Games/Music & Dance Games,728x90,4,0,0,0
ttd shopping sx,250x250,1,1,0,1
/All Apps/Google Play,300x50,111,8,4,4
DO NOT USE Mobile - MoPub - Online Communities,300x250,14,1,1,0
NYPR whitelist sx (Advertiser Level),300x250,0,5,0,5
Performing Arts Fort Worth sx,320x50,144,248,86,162
mogo marks branding comp rate silver video sx,970x250,1272,2072,364,1708
mogo marks branding drhbx silver sx,970x250,1427,3304,606,2698
mogo marks dallas sx,160x600,0,4,0,4
mogo marks natl cat-aff-im sx 2,320x50,4318,4495,1256,3239
/All Apps/Apple App Store/Lifestyle,320x50,499,17,2,15
Channel of Top Global Sites for Nielsen Video Ads - DO NOT EDIT,320x100,89,209,38,171
Mogo DBM basic video sx,320x100,2,0,0,0
mogo marks agg sx xsl37589,320x50,32967,46854,11665,35189
mogo marks native medium reach tail aggregate sx,970x250,1687,3405,567,2838
mogo marks opera sx,300x250,2,8,1,7
mogo marks pav kpi sx 3,970x90,1,4,0,4
mogo marks perf arts branding high reach sx,320x100,0,18,0,18
mogo marks video sx xsl44760 class a,320x50,44,171,21,150
ttd travel sx,970x90,3,0,0,0
Diablo DVC Shortlist (Advertiser Level),300x50,36,3306,56,3250
Duxiana - Underperformance Blacklist,320x50,253,17,10,7
mogo marks wine sx,300x600,1,8,0,8
mogo marks xsl66781 sx,250x250,0,2,0,2
mogo marks xsl_800p sx,300x50,162,5980,134,5846
/All Apps/Apple App Store/News,300x250,1198,47,30,17
/All Apps/Apple App Store/Weather,300x50,10,0,0,0
kid safe sx,320x50,3836,3990,944,3046
mogo marks hq100p sx,250x250,0,2,0,2
mogo marks natl cat-aff-im sx 2,728x90,426,3421,169,3252
mogo marks t1 brand kpi sx x8t,160x600,71,505,23,482
mogo marks xsl_74205 sx ,300x250,5471,15860,1619,14241
sfoc mogo youtube sx,Unknown,8,4,0,4
DO NOT USE Tier 1,970x250,1541,2847,503,2344
Pac Private Events/Wedding sx,300x250,19,112,4,108
mogo marks branding tier 2 sx xls37852,250x250,3,5,0,5
mogo marks perf arts sx 5 epx1,728x90,131,626,45,581
mogo marks video branding medium reach tail aggregate sx,320x50,25792,34663,9627,25036
sfoc cix sx,320x50,0,16,0,16
ttd music sx,320x50,804,625,271,354
/All Apps/Apple App Store/Utilities,300x250,15,1,1,0
/All Apps/Google Play/Games/Puzzle,160x600,1,0,0,0
Belmont Sitelist v1,160x600,52,123,49,74
DO NOT USE Tier 2,728x90,901,7652,322,7330
PAC Singapore sx,320x50,23,22,0,22
mogo marks agg sx xsl37589,Unknown,575,35,0,35
mogo marks branding comp rate gold video sx,728x90,2186,7723,669,7054
mogo marks broadway sx,300x50,0,8,0,8
mogo marks perf arts sx 11,320x100,1,4,0,4
mogo marks video branding extended reach tail aggregate sx,160x600,2425,8169,664,7505
ttd sports sx,300x50,18,92,7,85
/All Apps/Apple App Store/Games/Educational,320x50,12,0,0,0
/All Apps/Google Play/Games/Action,728x90,1,0,0,0
mogo biz-fi sx,300x50,7,114,2,112
mogo marks t1 brand kpi sx x8t,336x280,0,1,0,1
ttd travel sx,300x250,262,1942,116,1826
/All Apps/Apple App Store/Games/Family,300x600,22,1,1,0
/All Apps/Apple App Store/Games/Word,320x50,99,12,2,10
Mogo DBM premium video sx,970x250,1268,2391,416,1975
arizona opera top converters sx,300x600,6,15,4,11
mogo marks bwwpb sx,300x50,0,2,0,2
mogo marks houston sx,300x600,14,12,1,11
mogo mba tier 2 sx,970x90,1,2,0,2
Chicago T1 sites,728x90,15,31,11,20
mogo marks branding tier 3 sx xls37852,320x50,6740,11873,4174,7699
mogo marks email sx,728x90,62,89,14,75
mogo marks ttd obx kitchen premium sink sx,320x100,116,206,45,161
/All Apps/Google Play/Games/Racing,970x250,1,0,0,0
PAC Singapore sx,728x90,5,6,0,6
mogo marks branding comp rate silver video sx,468x60,0,1,0,1
mogo marks perf arts sx 6,320x100,1,4,0,4
/All Apps/Google Play/Music & Audio,320x50,390,39,17,22
Android Top Selling Free Music and Audio,336x280,4,3,3,0
mogo marks jazz & blues sx,970x250,0,2,0,2
mogo marks native sx xsl1045 class a,728x90,1015,2665,110,2555
DO NOT USE Invite December Brand Safe List,300x600,2772,9382,872,8510
mogo marks native sx xsl1045 class c,160x600,140,924,29,895
mogo marks pav kpi sx,300x600,72,225,31,194
ttd kids sx,300x600,27,84,12,72
/All Apps/Apple App Store/Navigation,320x50,66,2,0,2
RCU Blacklist Sites (CPA),160x600,3,3,0,3
mogo marks perf arts gold sx,970x250,47,182,61,121
sfoc stratford hqcat sx,300x250,54,722,49,673
ttd health wellness sx,970x90,2,2,0,2
/All Apps/Apple App Store/Sports,728x90,38,1,0,1
/All Apps/Google Play/Books & Reference,728x90,2,0,0,0
/All Apps/Google Play/Music & Audio,728x90,4,0,0,0
5a kpi sx,970x250,0,13,0,13
Brandcast Blacklist ,320x50,463,1040,110,930
DO NOT USE Rubicon,300x600,87,400,30,370
mogo financial services kpi sx,970x250,432,519,57,462
mogo marks branding max reach sx,970x90,35,40,1,39
Channel of Top US Sites for Nielsen Video Ads - DO NOT EDIT,160x600,2990,11171,868,10303
DSM African American sx,300x250,0,3,0,3
mogo marks denver sx,320x50,196,480,53,427
/All Apps/Apple App Store/Reference,728x90,43,1,1,0
mogo marks wedding sx,320x50,4,7,0,7
sfoc pslx 2018 sx (Jun_2018),160x600,101,520,59,461
Android Top Selling Free Business,300x600,1,0,0,0
Channel of Top Global Sites for Nielsen Display Ads - DO NOT EDIT,300x100,1,0,0,0
DCPA video local sx,300x250,6,10,1,9
Provident High CTR List ,320x50,119,2,0,2
mogo marks native (sharethrough) unique can sx,250x250,2,1,0,1
mogo marks natl elite cat-aff-im sx,336x280,0,1,0,1
mogo marks xsl66781 sx,300x600,1066,4784,436,4348
mogo marks chicago sx,300x50,0,5,0,5
mogo marks lal (purchase) platinum sx,300x250,825,4904,343,4561
mogo marks pav kpi hx,320x50,3555,4061,904,3157
mogo marks t1 brand kpi sx x8t,728x90,443,2918,177,2741
/All Apps,970x90,1,0,0,0
DO NOT USE Invite December Brand Safe List,320x100,64,93,30,63
Fan Extender IMG/Sidearm Blacklist,728x90,0,1,0,1
mogo black sx,320x50,738,525,67,458
mogo canada t1 sx,970x250,1027,1702,283,1419
mogo centro sx US (2014),728x90,879,3174,355,2819
mogo cult soph sx,970x250,759,1660,295,1365
mogo marks dallas sx,320x50,315,653,160,493
mogo marks hq100p sx,300x600,1887,6132,657,5475
ttd kids sx,320x100,15,12,7,5
/All Apps/Google Play/Productivity,300x600,28,3,2,1
DO NOT USE Tier 3,200x200,0,2,0,2
mogo marks bay area sx,300x600,79,311,33,278
mogo marks branding tier 2 sx xls37852,300x600,3067,11819,1093,10726
mogo marks visual arts sx,300x600,14,1,1,0
/All Apps/Google Play/Games/Casual,300x600,117,25,22,3
Android Top Selling Free Photography,300x600,196,89,82,7
DO NOT USE Tier 3,160x600,1766,6723,429,6294
mogo marks broadwayworld sx,160x600,48,363,22,341
Android Movers and Shakers,300x600,28,5,1,4
DO NOT USE Tier 1* (CHANNEL),336x280,2,24,1,23
Pac Fox Atlanta EXCLUSION List,300x600,7,15,3,12
allan- UOC  high click rate /  converter list ,300x600,0,4,0,4
mogo marks natl cat-aff-im sx 3,320x50,2684,2347,713,1634
mogo marks xsl_74205 sx ,250x250,0,2,0,2
mogo mba tier 1 sx,970x250,12,66,1,65
pac canada sports sx,160x600,33,76,3,73
mogo marks lal (purchase) gold sx,320x100,18,45,9,36
mogo marks natl cat-aff-im sx 3,728x90,280,2614,112,2502
/All Apps/Apple App Store/Games/Role Playing,300x600,1,0,0,0
/All Apps/Google Play/Personalization,300x600,1,0,0,0
DO NOT USE Tier 3 (2),300x600,125,516,51,465
Diablo DVC Shortlist (Advertiser Level),300x250,30,7644,113,7531
Western Black sx,320x50,98,931,29,902
mogo biz-fi sx,970x90,1,2,0,2
mogo financial services kpi sx,300x50,13,353,14,339
mogo marks branding drhbx gold sx,336x280,2,9,1,8
mogo marks xsl_800p sx,300x250,14196,51379,4314,47065
/All Apps/Google Play,300x250,2628,757,620,137
Belmont Sitelist v1,320x50,13,21,3,18
mogo black rt sx,300x250,2,8,0,8
mogo marks lal (purchase) silver sx,300x600,3060,15207,1161,14046
mogo marks lal branding (All) platinum sx,300x600,619,2170,177,1993
mogo universal rt+ob black sx,728x90,5,4,1,3
sfoc kpi sx (acquisition 2019),300x250,31,725,33,692
DO NOT USE Tier 1* (CHANNEL),300x250,9630,31392,2999,28393
DO NOT USE fgu test public channel,970x250,123,183,39,144
Lynn Undergrad,160x600,24,250,7,243
dbm native sx (adx),300x600,1203,3477,384,3093
dbm video sx,320x100,36,45,16,29
ttd beauty sx,300x50,0,4,0,4
/All Apps/Apple App Store/News,728x90,210,12,7,5
/All Apps/Apple App Store/Photo & Video,300x600,4,0,0,0
/All Apps/Google Play/Games/Simulation,300x250,24,1,1,0
DCPA display local sx,970x250,1,1,1,0
DO NOT USE Tier 3,970x90,15,11,0,11
mogo marks bay area sx,160x600,5,25,6,19
mogo marks native sx xsl1045 class c,320x100,33,47,18,29
ttd finance sx,320x100,6,3,2,1
mogo marks seattle sx,300x250,75,117,8,109
mogo marks wine sx,320x50,35,219,10,209
mogo marks xsl_800p sx,200x200,0,3,0,3
mogo mba tier 2 sx,300x50,22,384,11,373
/All Apps,728x90,3530,290,266,24
/All Apps/Apple App Store/Education,300x600,18,0,0,0
/All Apps/Apple App Store/Games/Sports,300x250,1,0,0,0
DO NOT USE Tier 3* (CHANNEL) (2),320x100,4,14,3,11
magic theatre top performing sx,320x50,404,292,257,35
mogo marks native standard reach (no) tail aggregate sx,160x600,1029,6400,299,6101
mogo marks natl canada cat-aff-im sx,300x600,177,1049,105,944
mogo marks video branding max reach tail aggregate sx,970x250,1986,3763,666,3097
ttd spanish sx,160x600,11,11,2,9
/All Apps/Google Play/Travel & Local,300x600,2,0,0,0
mogo marks xsl66781 sx,160x600,185,1080,62,1018
ocfta local madison sx,160x600,0,17,0,17
/All Apps/Apple App Store/Navigation,300x50,3,0,0,0
Channel of Top non-US Sites for Nielsen Display Ads - DO NOT EDIT,728x90,4408,20070,1093,18977
Duxiana - Longtail Blacklist,160x600,17,0,0,0
Mercury Theater Chicago sx,728x90,84,83,76,7
mogo lydia peacecenter test,728x90,1679,4452,379,4073
ttd education sx,336x280,2,1,1,0
/All Apps/Google Play/Education,320x50,52,8,7,1
mogo marks lal branding (All) silver sx,200x200,0,1,0,1
ttd weather sx,320x50,3190,3516,3015,501
/All Apps/Google Play/Finance,320x50,27,0,0,0
Channel of Top Global Sites for Nielsen Display Ads - DO NOT EDIT,970x90,25,30,0,30
mogo marks high intenders sx,250x250,0,2,0,2
mogo marks pav kpi sx 2,320x50,1609,3099,577,2522
ttd news sx,300x600,1716,4478,584,3894
/All Apps/Google Play/Games,970x250,5,1,1,0
Android Top Selling Free Game,300x250,102,24,24,0
fgu test public channel,970x250,123,183,39,144
mogo marks xsl_74205 (4p dims) sx ,970x250,629,1763,317,1446
/All Apps/Google Play/News & Magazines,300x50,6,0,0,0
mogo marks kpi mdx sx xls9297,300x250,2502,7804,872,6932
mogo marks natl cat-aff-im sx 3,320x100,0,4,0,4
mogo marks video sx xsl44760 class a,160x600,167,137,63,74
DO NOT USE Tier 3* (CHANNEL) (2),336x280,0,6,0,6
mogo marks outbound kpi sx x1a,300x600,364,554,116,438
mogo universal rt+ob black sx,300x600,3,13,3,10
ttd family parent sx,970x250,83,50,17,33
Channel of Top Global Sites for Nielsen Video Ads - DO NOT EDIT,250x250,10,9,0,9
Mogo DBM basic video sx,250x250,0,1,0,1
at atlanta sx,728x90,3,24,4,20
mogo marks branding tier 2 sx xls37852,320x100,86,154,39,115
mogo marks perf arts sx 2,970x90,1,3,0,3
sfoc hqcat black hx,300x600,3,59,2,57
ttd finance sx,336x280,0,1,0,1
CST KPI List,160x600,3,6,1,5
DO NOT USE OAM UK,300x600,157,220,25,195
dbm video sx,336x280,0,1,0,1
mogo marks broadway sx,160x600,75,562,28,534
mogo marks hq100p sx,320x100,50,115,24,91
mogo marks lal branding (All) gold sx,728x90,1929,16571,625,15946
mogo marks native sx xsl1045 class c,336x280,2,3,0,3
pac esports sx,300x250,349,2122,63,2059
mogo marks native standard reach (no) tail aggregate sx,320x100,81,119,40,79
mogo marks xsl_ks0001 sx,970x90,23,18,1,17
mogo mba tier 2 sx,320x50,1276,2226,470,1756
sfoc 2018 marks stratford premium sx,970x250,67,372,61,311
sfoc marks lal custom sx,160x600,5,15,3,12
Mogo DBM select video sx,970x250,10,18,2,16
Portland Center Stage KPI sx,728x90,2,7,2,5
mogo marks native high reach tail aggregate sx,300x100,1,0,0,0
mogo marks native sx xsl1045 class b,160x600,31,279,5,274
mogo marks xsl66781 sx,320x100,12,31,8,23
ttd beauty sx,320x50,3,4,1,3
ttd food sx,970x90,2,4,0,4
/All Apps/Google Play/Lifestyle,728x90,6,0,0,0
Android Top Selling Free News and Magazines,300x250,769,155,86,69
ttd music sx,970x250,25,40,26,14
/All Apps/Apple App Store/Music,300x600,3,0,0,0
kid safe sx,970x250,631,556,145,411
mogo marks agg sx xsl37589,970x250,2128,4070,702,3368
mogo marks lal branding (All) gold sx,250x250,0,6,0,6
mogo marks perf arts gold sx,320x50,193,982,95,887
mogo marks xsl_ks0001 sx,Unknown,575,35,0,35
sfoc marks kpi sx (062018),300x250,22,406,23,383
/All Apps/Apple App Store/Productivity,320x50,78,1,1,0
mogo financial services kpi sx,320x50,3073,2236,746,1490
mogo marks shakespeare sx,300x600,1,0,0,0
mogo marks video branding extended reach tail aggregate sx,200x200,0,1,0,1
/All Apps/Apple App Store/Lifestyle,728x90,78,4,3,1
Duxiana- Bad Site List(Allan) ,300x600,12,1,0,1
Provident High CTR List ,160x600,1,0,0,0
Stratford Black RT SX,300x250,0,3,0,3
mogo marks branding drhbx platinum sx,970x250,439,1097,191,906
mogo marks high intenders sx,300x250,346,1714,119,1595
mogo marks jazz & blues sx,320x50,42,339,39,300
mogo marks video branding medium reach tail aggregate sx,970x250,1866,3503,585,2918
mogo marks video sx xsl44760 class b,300x600,760,1750,251,1499
sfoc cix sx,970x250,0,23,0,23
zt local austin sx,300x250,19,127,19,108
/All Apps/Apple App Store/Games/Card,728x90,803,72,68,4
Duxiana - Underperformance Blacklist,970x250,73,1,1,0
mogo black sx,160x600,318,382,75,307
mogo marks natl cat-aff-im sx 2,970x250,803,2062,398,1664
/All Apps/Apple App Store/Games/Puzzle,728x90,1831,170,163,7
Arvada local sx,728x90,0,18,0,18
Channel of Top non-US Sites for Nielsen Video Ads - DO NOT EDIT,300x600,2621,11337,852,10485
mogo marks bay area sx,300x50,4,47,0,47
mogo marks lal branding (All) silver sx,160x600,1510,12784,509,12275
mogo marks pav kpi hx,970x250,626,1679,274,1405
/All Apps/Apple App Store/Health & Fitness,300x250,8,0,0,0
Channel of Top US Sites for Nielsen Video Ads - DO NOT EDIT,320x50,31691,40298,11207,29091
mogo marks bw-theatre sx,300x600,2,4,1,3
mogo marks wedding sx,970x250,1,0,0,0
mogo marks xsl66781 sx,300x50,16,453,18,435
mogo marks xsl_74205 (2p dims) sx ,160x600,478,2072,126,1946
pac motorsports sx,970x250,114,158,31,127
ttd food sx,320x100,18,48,9,39
ttd health sx,728x90,110,1399,39,1360
/All Apps/Apple App Store/Games/Simulation,728x90,38,0,0,0
DO NOT USE Tier 3,336x280,11,58,3,55
Lynn DMAC,300x250,33,160,18,142
mogo marks native standard reach (no) tail aggregate sx,300x50,96,3186,82,3104
mogo marks outbound kpi sx x1a,160x600,87,735,31,704
pac esports sx,Unknown,575,35,0,35
ttd male sx,300x250,471,1724,172,1552
/All Apps/Apple App Store/Entertainment,728x90,2764,258,244,14
Android Top Selling Free Education,728x90,1,0,0,0
mogo marks branding comp rate platinum video sx,728x90,1396,3300,301,2999
mogo marks high intenders sx,970x90,1,0,0,0
mogo marks travel sx,728x90,310,536,17,519
/All Apps/Apple App Store/Games,320x50,845,35,20,15
mogo marks broadwayworld sx,336x280,0,1,0,1
sfoc pslx 2018 sx (Jun_2018_Archived),300x250,288,3866,255,3611
ttd sports sx,300x250,561,1623,122,1501
/All Apps/Google Play/Games/Sports,300x250,2,0,0,0
DO NOT USE AppNexus - Collective Media,320x100,38,32,17,15
Mogo DBM basic video sx,300x250,199,574,45,529
mogo biz-fi sx,320x100,2,0,0,0
mogo t1 brand sx,970x90,11,4,0,4
ttd male sx,970x250,78,108,26,82
DO NOT USE Tier 3 (2),160x600,197,633,45,588
mogo marks branding comp rate silver video sx,300x600,2172,5434,734,4700
mogo marks branding drhbx silver sx,300x600,3716,14954,1395,13559
mogo marks video branding max reach tail aggregate sx,468x60,1,3,0,3
provident shortlist ,320x100,87,124,40,84
Channel of Top Global Sites for Nielsen Video Ads - DO NOT EDIT,300x250,15918,47844,4310,43534
Performing Arts Fort Worth Top sx,300x250,33,128,12,116
mogo marks branding max reach sx,300x50,292,9823,226,9597
mogo marks bwwpb sx,320x100,0,4,0,4
mogo marks native medium reach tail aggregate sx,300x600,3252,13999,1148,12851
mogo marks ttd obx kitchen premium sink sx,970x90,23,18,1,17
sfoc pslx 2018 sx (Jun_2018_Archived),970x250,73,377,64,313
ttd sports sx,970x250,77,176,20,156
/All Apps/Apple App Store/Games/Strategy,300x600,3,2,1,1
/All Apps/Apple App Store/Social Networking,300x600,10,1,1,0
/All Apps/Google Play/Games/Arcade,320x50,39,6,6,0
Pac Fox Atlanta EXCLUSION List,160x600,0,6,0,6
mogo marks denver sx,160x600,1,29,0,29
mogo marks lal branding (All) silver sx,970x90,20,19,0,19
mogo marks xsl_74205 (2p dims) sx ,970x90,2,4,0,4
ttd auto sx,300x250,55,245,5,240
ttd health wellness sx,300x50,15,994,26,968
Channel of Top Global Sites for Nielsen Display Ads - DO NOT EDIT,320x50,32898,41056,11107,29949
DO NOT USE Mobile - MoPub - Jobs & Education,300x250,1,0,0,0
mogo cult soph sx,250x250,1,1,0,1
mogo marks branding tier 3 sx xls37852,336x280,0,2,0,2
mogo marks detroit sx,728x90,62,63,47,16
mogo marks lal (purchase) gold sx,300x50,51,1795,47,1748
/All Apps/Apple App Store/Games/Board,300x250,307,13,13,0
mogo marks agg sx xsl37589,300x100,1,0,0,0
mogo marks branding max reach sx,300x250,19477,71648,5761,65887
mogo marks native standard reach (no) tail aggregate sx,970x250,1566,2982,508,2474
mogo marks seattle sx,970x90,0,1,0,1
mogo CBS Interactive sx,250x250,1,0,0,0
/All Apps/Google Play/Social,320x50,2179,94,76,18
Channel of Top US Sites for Nielsen Display Ads - DO NOT EDIT,728x90,8926,40513,2882,37631
mogo marks native high reach tail aggregate sx,160x600,1920,8346,497,7849
provident shortlist ,728x90,2683,14686,964,13722
5a kpi sx,160x600,5,75,0,75
Duxiana - KPI sx,300x250,116,21,4,17
Stratford KPI revised,300x250,0,186,0,186
mogo marks sacramento sx,300x600,3,3,2,1
Top Performing Sites,728x90,196,99,35,64
mogo marks branding tier 3 sx xls37852,200x200,0,1,0,1
mogo marks houston sx,300x50,0,2,0,2
mogo marks lal (purchase) gold sx,300x600,1518,8312,561,7751
mogo marks lal (purchase) platinum sx,970x250,184,547,98,449
mogo marks natl cat-aff-im sx,160x600,199,1252,65,1187
mogo marks visual arts sx,728x90,5,9,0,9
ttd health wellness sx,300x250,221,1831,68,1763
DO NOT USE Mobile - MoPub - Arts & Entertainment/Entertainment Industry/Recording Industry,300x250,81,3,3,0
DO NOT USE Tier 1,160x600,1040,7786,398,7388
DO NOT USE Tier 3* (CHANNEL),336x280,11,58,3,55
GG KPI sx,300x250,5,9,0,9
mogo marks coupon sx,728x90,2,94,13,81
mogo marks email sx,320x50,3,1,0,1
/All Apps/Google Play/Games/Action,320x50,21,9,9,0
Channel of Top non-US Sites for Nielsen Video Ads - DO NOT EDIT,970x90,9,11,0,11
DO NOT USE Tier 2,320x50,2504,4418,672,3746
dso kpi audx sx,300x250,6,172,5,167
mogo marks branding comp rate gold video sx,320x50,9859,12322,5028,7294
mogo marks lal branding (All) silver sx,728x90,2995,23898,1080,22818
mogo marks pav kpi sx 3,300x250,1290,2837,414,2423
mogo marks perf arts platinum sx,300x50,0,7,0,7
mogo marks perf arts sx 11,970x250,24,130,52,78
mogo marks xsl_ks0001 sx,200x200,0,3,0,3
mogo perf arts sx,728x90,243,1344,92,1252
DO NOT USE Tier 3,468x60,0,3,0,3
mogo marks branding drhbx silver sx,160x600,1157,4831,299,4532
Android Top Selling Free Weather,728x90,11,0,0,0
BR Native sx,300x250,19,85,9,76
Channel of Top Global Sites for Nielsen Video Ads - DO NOT EDIT,300x100,1,0,0,0
mogo marks lal (purchase) silver sx,250x250,2,10,0,10
mogo marks perf arts sx 6,970x250,24,130,52,78
ttd entertainment sx,336x280,2,2,0,2
/All Apps/Google Play/News & Magazines,300x250,836,171,99,72
DO NOT USE AppNexus - Collective Media,300x50,60,1449,67,1382
mogo marks native medium reach tail aggregate sx,160x600,1392,7161,377,6784
mogo sf local sx,970x250,20,42,6,36
mogo t1 brand sx,320x100,39,66,11,55
/All Apps/Apple App Store/Social Networking,300x50,6,0,0,0
/All Apps/Google Play/Games/Trivia,320x50,20,4,2,2
arizona opera top converters sx,970x250,12,26,9,17
mogo lydia peacecenter test,970x90,7,2,0,2
mogo marks branding comp rate silver video sx,300x50,40,1148,33,1115
mogo marks houston sx,970x250,0,1,0,1
mogo marks xsl_74205 (4p dims) sx ,970x90,1,4,0,4
Channel of Top Global Sites for Nielsen Display Ads - DO NOT EDIT,200x200,0,3,0,3
Mogo DBM basic video sx,300x50,13,151,11,140
education master sx,728x90,967,4861,352,4509
mogo marks pav kpi hx,250x250,0,3,0,3
ttd news sx,160x600,225,719,70,649
/All Apps/Apple App Store/Games/Dice,320x50,12,0,0,0
fgu test public channel,970x90,3,0,0,0
mogo marks branding increased reach sx,728x90,8543,44296,2868,41428
/All Apps/Apple App Store/Games/Card,300x600,673,49,39,10
DCPA Video black sx,728x90,1,0,0,0
SP News Black sx,300x250,34,241,42,199
finn dallas native sx,160x600,62,124,27,97
sfoc rtx kpi sx,320x50,38,159,21,138
ttd tech sx,728x90,141,563,50,513
/All Apps/Google Play/Lifestyle,300x600,38,5,5,0
mogo marks branding increased reach sx,320x50,34697,48445,12286,36159
mogo marks native medium reach tail aggregate sx,300x50,153,4358,122,4236
ttd auto sx,300x50,1,197,1,196
education master sx,300x250,2118,6279,680,5599
mogo marks bay area sx,728x90,70,595,32,563
mogo marks branding tier 2 sx xls37852,320x50,15526,24799,6784,18015
mogo marks lal (purchase) platinum sx,728x90,490,1879,101,1778
Nashville Symphony black list all adgroups,300x250,3,98,5,93
mogo marks branding comp rate gold video sx,320x100,40,35,16,19
mogo marks branding comp rate platinum video sx,336x280,0,1,0,1
mogo marks cincinnati sx,970x250,1,0,0,0
mogo marks xsl66781 sx,320x50,2356,5866,793,5073
sfoc rtx kpi sx,300x600,3,26,3,23
ttd news sx,250x250,0,3,0,3
ttd tech sx,300x250,332,1117,73,1044
/All Apps/Google Play/Games/Trivia,300x600,20,1,1,0
/All Apps/Google Play/Productivity,320x50,107,6,4,2
mogo marks bay area sx,320x50,385,567,159,408
mogo marks hq100p sx,320x50,8398,15584,4739,10845
mogo marks native standard reach (no) tail aggregate sx,728x90,3408,19356,1040,18316
mogo marks visual arts sx,320x50,45,15,5,10
Android Top Selling Free Business,320x50,13,0,0,0
Channel of Top Global Sites for Nielsen Display Ads - DO NOT EDIT,120x600,1,0,0,0
DO NOT USE Tier 2,320x100,12,12,5,7
ttd female sx,970x90,3,2,0,2
/All Apps/Apple App Store/Games/Dice,300x600,1,0,0,0
/All Apps/Apple App Store/Games/Word,970x250,3,0,0,0
Performing Arts Fort Worth Perf Arts 5 black sx,320x50,12,9,1,8
mogo marks branding tier 3 sx xls37852,970x250,838,2093,388,1705
Android Top Selling Free Books and Reference,320x50,67,19,10,9
mogo marks broadwayworld sx,970x250,15,86,47,39
mogo marks seattle sx,160x600,0,2,0,2
mogo marks native (sharethrough) unique us sx,320x100,10,19,2,17
mogo marks xsl_ks20780 sx,320x50,30577,43074,11026,32048
/All Apps/Apple App Store/Games,300x50,14,0,0,0
PAC Singapore sx,300x250,44,66,0,66
mogo marks perf arts sx 7,320x50,210,1207,107,1100
mogo marks xsl_800p sx,970x90,17,24,0,24
ttd news sx,336x280,0,5,0,5
ttd spanish sx,300x600,11,40,1,39
mogo canada t1 sx,728x90,1581,5015,242,4773
mogo cult soph sx,728x90,875,3957,401,3556
mogo marks email sx,300x250,640,2479,177,2302
mogo marks pav kpi sx,320x100,0,4,0,4
mogo marks phoenix sx,728x90,88,237,51,186
mogo marks t1 brand sx trim,200x200,0,1,0,1
mogo marks video branding max reach tail aggregate sx,970x90,29,24,0,24
ttd female sx,160x600,14,155,3,152
/All Apps/Google Play/Shopping,320x50,21,0,0,0
pac canada sports sx,970x250,103,239,37,202
ttd health sx,300x50,15,1008,26,982
Mogo DBM premium video sx,200x200,0,1,0,1
Nashville Symphony black list all adgroups,300x600,2,49,6,43
mogo marks branding comp rate silver video sx,160x600,1730,5232,460,4772
DCPA video local sx,320x50,34,56,0,56
DO NOT USE Mobile - MoPub - Computers & Electronics/Software/Business & Productivity Software,320x50,1,0,0,0
Pac Fox Atlanta EXCLUSION List,300x250,98,205,20,185
dbm native sx (adx),336x280,3,2,0,2
iab aff-im black sx,300x600,1,0,0,0
mogo marks agg sx xsl37589,160x600,5403,23411,1665,21746
mogo marks lal branding (All) silver sx,970x250,1215,3090,513,2577
mogo marks san francisco sx,300x50,2,39,0,39
/All Apps/Google Play/Games,728x90,134,11,11,0
Performing Arts Fort Worth Test List,300x600,4,14,0,14
co top 41 converting,300x250,1,11,0,11
kid safe sx,160x600,302,908,104,804
mogo marks outbound kpi sx x1a,320x100,1,4,0,4
mogo marks xsl_74205 (4p dims) sx ,728x90,330,2664,140,2524
mogo perf arts sx,970x250,469,1135,235,900
/All Apps/Google Play/Games/Board,300x250,12,3,3,0
fgu test public channel,728x90,225,834,56,778
mogo marks branding elite tier sx xls37852,300x50,2,61,1,60
mogo marks natl canada cat-aff-im sx,336x280,0,1,0,1
mogo marks natl cat-aff-im sx 2,160x600,154,969,47,922
mogo marks video sx xsl44760 class c,300x50,53,1699,30,1669
mogo marks xsl_74205 (2p dims) sx ,320x100,12,31,8,23
/All Apps/Google Play/Games/Casual,300x250,59,5,5,0
mogo marks xsl_ks20780 sx,468x60,1,4,0,4
Android Movers and Shakers,728x90,2,0,0,0
Brandcast Blacklist ,970x250,82,38,17,21
mogo marks native sx xsl1045 class a,320x100,1,4,4,0
mogo marks t1 brand kpi sx x8t,300x600,606,2473,273,2200
/All Apps/Google Play/News & Magazines,728x90,19,2,1,1
Android Top Selling Free Tools,336x280,5,0,0,0
DO NOT USE Mobile - MoPub - Computers & Electronics/Software/Multimedia Software/Audio & Music Software,300x250,81,3,3,0
Nashville Local sx,300x250,4,133,6,127
Pac Fox Atlanta EXCLUSION List,728x90,58,121,9,112
mogo marks denver sx,728x90,45,266,13,253
mogo marks lal branding (All) platinum sx,728x90,398,2663,180,2483
mogo marks perf arts gold sx,320x100,0,4,0,4
mogo marks playbill 5 sx x9z,300x250,139,592,59,533
Channel of Top non-US Sites for Nielsen Display Ads - DO NOT EDIT,336x280,11,26,0,26
DO NOT USE Tier 3 (2),728x90,284,2047,103,1944
Pac Private Events/Wedding sx,160x600,0,1,0,1
mogo canada t1 sx,300x600,1121,3516,369,3147
mogo marks phoenix sx,300x600,13,25,3,22
mogo marks toronto sx,970x90,1,2,0,2
mogo marks xsl_74205 sx ,160x600,478,2074,126,1948
DO NOT USE Spanish Language Sites,160x600,5,12,2,10
mogo cult soph sx,300x600,1094,3305,379,2926
mogo lydia peacecenter test,336x280,3,1,0,1
mogo marks kpi achievers sx,160x600,87,735,31,704
mogo marks native high reach tail aggregate sx,200x200,0,3,0,3
mogo marks video sx xsl44760 class c,200x200,0,2,0,2
/All Apps,160x600,153,6,4,2
/All Apps/Google Play/Games/Board,320x50,33,1,1,0
Greg's GG KPI + relevant sites list,300x250,4,17,0,17
mogo financial services kpi sx,320x100,6,5,0,5
mogo marks video sx xsl44760 class b,300x50,5,69,1,68
ttd finance sx,160x600,43,177,8,169
/All Apps/Apple App Store/Sports,300x250,41,0,0,0
/All Apps/Google Play/Books & Reference,300x250,6,2,2,0
Brandcast Blacklist ,300x600,167,1297,58,1239
mogo marks branding increased reach sx,320x100,154,308,58,250
mogo marks disney sx,300x50,0,3,0,3
mogo marks native sx xsl1045 class a,300x250,2152,6253,552,5701
mogo marks t1 brand sx trim,160x600,497,1661,148,1513
mogo marks trip advisor sx,160x600,1,34,0,34
Channel of Top Global Sites for Nielsen Video Ads - DO NOT EDIT,160x600,2475,9617,748,8869
Performing Arts Fort Worth Top sx,160x600,6,19,4,15
dbm video sx,250x250,1,4,0,4
mogo marks outbound kpi sx x1a,320x50,3332,4374,3077,1297
mogo marks perf arts branding high reach sx,160x600,129,704,54,650
mogo universal rt+ob black sx,320x50,2,1,0,1
pac esports sx,728x90,48,752,30,722
ttd music sx,300x50,3,53,3,50
/All Apps/Apple App Store/Lifestyle,300x50,5,0,0,0
/All Apps/Google Play/Games/Card,970x250,3,0,0,0
DO NOT USE OAM UK,320x50,260,242,70,172
mogo marks denver sx,300x600,16,81,8,73
sfoc hqcat black hx,320x50,10,123,6,117
ttd finance sx,250x250,0,1,0,1
ttd gaming sx,970x250,7,3,1,2
/All Apps/Apple App Store,970x250,28,1,1,0
/All Apps/Google Play/Music & Audio,300x600,54,6,6,0
South Coast Rep Perf Arts 5 black sx,300x250,0,1,0,1
mogo marks jazz & blues sx,300x50,1,21,1,20
mogo mba tier 1 sx,728x90,23,365,11,354
mogo marks native sx xsl1045 class c,250x250,2,1,0,1
provident shortlist ,970x90,7,9,0,9
Duxiana - Longtail Blacklist,300x250,47,0,0,0
Duxiana - Underperformance Blacklist,300x600,39,1,0,1
mogo marks xsl66781 sx,336x280,0,2,0,2
/All Apps/Apple App Store/Lifestyle,300x600,9,0,0,0
Channel of Top non-US Sites for Nielsen Video Ads - DO NOT EDIT,200x200,0,1,0,1
arizona opera top converters sx,728x90,8,24,6,18
co top 41 converting,160x600,1,0,0,0
mogo marks branding tier 2 sx xls37852,336x280,2,9,0,9
mogo perf arts sx,970x90,1,2,0,2
/All Apps/Apple App Store/Games/Family,728x90,53,1,0,1
/All Apps/Google Play/Business,320x50,6,17,16,1
/All Apps/Google Play/Games/Board,160x600,5,1,1,0
LSSU url v1,300x250,10,335,4,331
mogo marks agg sx xsl37589,300x600,5992,24595,2084,22511
mogo marks houston sx,728x90,50,29,4,25
mogo marks perf arts sx 5 epx1,300x250,420,1906,198,1708
mogo marks philadelphia sx,728x90,25,11,6,5
mogo marks video branding medium reach tail aggregate sx,300x600,4182,15599,1448,14151
mogo marks video sx xsl44760 class a,300x600,297,602,101,501
sfoc cix sx,300x600,5,97,13,84
ttd music sx,300x600,26,123,8,115
DO NOT USE Tier 2,970x90,4,9,0,9
Lynn General,728x90,32,199,21,178
Performing Arts Fort Worth sx,300x600,1,2,1,1
at iab aff-im black sx,300x600,1,2,0,2
mogo marks kpi mdx sx xls9297,160x600,272,1678,83,1595
mogo marks natl cat-aff-im sx 2,300x600,1000,3562,409,3153
mogo marks xsl_800p sx,300x100,1,0,0,0
Channel of Top Global Sites for Nielsen Display Ads - DO NOT EDIT,970x250,2010,3837,657,3180
Performing Arts Fort Worth Test List,160x600,2,22,1,21
kid safe sx,300x600,859,2483,265,2218
maryland-dc sx,320x50,2,2,1,1
mogo black sx,250x250,0,1,0,1
mogo marks hq100p sx,336x280,1,3,1,2
mogo marks video branding max reach tail aggregate sx,300x100,1,0,0,0
/All Apps/Apple App Store,160x600,143,3,2,1
Channel of Top US Sites for Nielsen Display Ads - DO NOT EDIT,300x250,20005,64875,5343,59532
DO NOT USE Tier 3* (CHANNEL),320x100,63,146,24,122
RCU KPI Sitelist 1 (CPA),300x250,0,11,0,11
Top Performing Sites,300x250,576,278,116,162
mogo marks perf arts sx 2,728x90,311,1699,115,1584
mogo marks perf arts sx 5 rx1,300x250,438,1969,201,1768
/All Apps/Google Play/Social,300x600,424,52,50,2
mogo marks wedding sx,728x90,1,21,1,20
pac motorsports sx,320x50,426,831,70,761
ttd entertainment sx,320x100,24,71,9,62
mogo centro sx US (2014),970x250,62,130,29,101
mogo marks elite kpi achievers sx,336x280,0,1,0,1
DO NOT USE Android Top Selling Free Media and Video,320x50,7,3,3,0
mogo marks branding elite tier sx xls37852,250x250,0,2,0,2
mogo marks native high reach tail aggregate sx,250x250,4,8,0,8
mogo marks nyc sx,970x90,1,2,0,2
mogo marks perf arts sx 2,320x50,415,1668,181,1487
mogo marks video sx xsl44760 class c,250x250,1,5,0,5
provident shortlist ,300x250,8981,25126,2389,22737
ttd gaming sx,160x600,551,504,107,397
/All Apps/Google Play/Sports,728x90,8,1,1,0
mogo marks branding comp rate gold video sx,300x50,19,462,28,434
mogo marks branding comp rate platinum video sx,320x50,5147,7382,3719,3663
mogo marks pav kpi hx,728x90,685,3704,303,3401
mogo marks t1 brand kpi sx x8t,970x250,817,1991,390,1601
sfoc pslx 2019 sx (Mar_2019),300x250,333,4244,319,3925
ttd female sx,320x100,1,0,0,0
ttd food sx,728x90,188,2383,84,2299
/All Apps/Google Play/Games/Strategy,728x90,1,0,0,0
Android Top Selling Free Books and Reference,300x250,22,5,2,3
PAC Singapore Rugby sx,728x90,1,0,0,0
SP News Black sx,300x600,4,9,4,5
ttd tech sx,320x50,574,601,110,491
Channel of Top US Sites for Nielsen Display Ads - DO NOT EDIT,336x280,42,60,4,56
education master sx,320x50,2599,4012,799,3213
mogo canada t1 sx,300x250,4461,12027,1342,10685
mogo marks t1 brand sx trim,300x50,51,764,40,724
provident shortlist ,336x280,0,5,0,5
Channel of Top Global Sites for Nielsen Video Ads - DO NOT EDIT,300x50,206,5767,142,5625
Duxiana - Longtail Blacklist,300x600,30,8,0,8
mogo marks xsl_ks20780 sx,300x250,17055,62050,5134,56916
mogo marks perf arts sx 7,300x250,310,1400,137,1263
