Advertiser Currency,Channel,Creative Size,Revenue (Adv Currency),Impressions,Active View: Viewable Impressions,Clicks,Total Conversions,Post-Click Conversions,Post-View Conversions
USD,/All Apps/Apple App Store,970x250,29.14195,1438,1282,29,3,3,0
USD,/All Apps/Google Play/Music & Audio,300x600,28.886194,1125,1030,43,5,5,0
USD,South Coast Rep Perf Arts 5 black sx,300x250,6.837817,665,585,0,0,0,0
USD,mogo marks jazz & blues sx,300x50,10.018067,1084,1012,2,19,1,18
USD,mogo mba tier 1 sx,728x90,560.58166,39527,34422,19,358,8,350
USD,/All Apps/Apple App Store/Lifestyle,300x50,12.905082,1089,1043,5,0,0,0
USD,/All Apps/Google Play/Games/Card,970x250,3.573999,213,198,3,0,0,0
USD,DO NOT USE OAM UK,320x50,754.217541,161207,151409,269,260,77,183
USD,mogo marks denver sx,300x600,139.514217,8480,7417,16,74,6,68
USD,sfoc hqcat black hx,320x50,62.713447,15709,14712,10,114,5,109
USD,ttd finance sx,250x250,1.241367,110,100,0,1,0,1
USD,ttd gaming sx,970x250,31.132294,6629,4836,5,2,0,2
USD,/All Apps/Apple App Store/Navigation,300x600,0.07107,3,2,0,0,0,0
USD,Walnut Street Theatre - In-Stream Video Blacklist,300x250,0.44463,67,43,0,0,0,0
USD,mogo marks elite kpi achievers sx,300x100,0.153683,27,20,0,0,0,0
USD,mogo marks native sx xsl1045 class c,250x250,17.193258,2491,1986,2,2,0,2
USD,mogo marks pav kpi sx,468x60,0.004844,2,0,0,0,0,0
USD,provident shortlist ,970x90,136.952722,10137,8665,7,9,0,9
USD,/All Apps/Apple App Store/Sports,300x250,74.450964,19737,15915,39,0,0,0
USD,/All Apps/Google Play/Books & Reference,300x250,3.910956,202,175,3,2,2,0
USD,/All Apps/Google Play/Tools,970x250,0.028577,5,3,0,0,0,0
USD,BBB black sx,728x90,1.039564,113,103,0,0,0,0
USD,Brandcast Blacklist ,300x600,2442.984018,678869,536774,166,1266,62,1204
USD,DO NOT USE Tier 3* (CHANNEL) (2),250x250,4.469069,562,460,0,0,0,0
USD,mogo marks branding increased reach sx,320x100,417.527733,65565,60500,109,220,32,188
USD,mogo marks disney sx,300x50,1.511433,166,156,0,7,0,7
USD,mogo marks native sx xsl1045 class a,300x250,14710.94745,3526482,2961598,2025,6299,552,5747
USD,mogo marks t1 brand sx trim,160x600,5319.343467,1777548,1599998,466,1714,146,1568
USD,mogo marks trip advisor sx,160x600,21.211682,427,320,1,34,0,34
USD,/All Apps/Google Play/Games/Adventure,970x250,0.01633,3,3,0,0,0,0
USD,Android Top Selling Free Social,160x600,0.012506,3,3,0,0,0,0
USD,Channel of Top Global Sites for Nielsen Video Ads - DO NOT EDIT,160x600,23823.4442,7085663,6309482,2670,10237,772,9465
USD,Performing Arts Fort Worth Top sx,160x600,50.677441,8048,7286,1,13,1,12
USD,dbm video sx,250x250,21.609586,2674,2182,1,3,0,3
USD,mogo marks outbound kpi sx x1a,320x50,8442.046376,423671,385618,3324,4240,2956,1284
USD,mogo marks perf arts branding high reach sx,160x600,1897.46227,122326,91781,132,632,57,575
USD,mogo marks sports sx,336x280,1.37207,122,97,0,0,0,0
USD,mogo universal rt+ob black sx,320x50,1.51224,272,225,2,0,0,0
USD,pac esports sx,728x90,956.887669,137810,118387,47,834,33,801
USD,ttd music sx,300x50,25.265885,5616,5243,3,46,3,43
USD,/All Apps/Google Play/Games/Strategy,300x250,0.831,126,114,0,0,0,0
USD,DCPA video local sx,728x90,93.296812,7426,5557,4,87,2,85
USD,Mogo DBM basic video sx,300x100,0.202172,29,27,0,0,0,0
USD,PAC Singapore Rugby sx,300x250,30.424704,2723,2230,1,7,0,7
USD,Performing Arts Fort Worth sx,160x600,0.013311,1,0,0,0,0,0
USD,finn dallas native sx,250x250,0.065555,10,3,0,0,0,0
USD,mogo marks branding increased reach sx,300x600,52139.40443,6395216,5301395,5799,24652,2176,22476
USD,mogo marks native sx xsl1045 class b,300x50,105.476511,15510,14859,15,410,7,403
USD,mogo marks playbill sx x3e,300x50,0.008855,11,9,0,0,0,0
USD,/All Apps/Google Play/Games/Action,970x250,0.051049,22,18,0,0,0,0
USD,mogo marks branding comp rate gold video sx,970x250,6232.043903,852608,748229,1187,2029,388,1641
USD,mogo marks detroit sx,300x50,0.188441,67,63,0,0,0,0
USD,mogo marks lal (purchase) platinum sx,320x50,10716.49868,783107,697454,3655,5274,3104,2170
USD,mogo marks lal branding (All) platinum sx,240x400,0.012357,1,1,0,0,0,0
USD,mogo marks perf arts sx 2,336x280,1.069314,55,42,0,2,0,2
USD,mogo marks perf arts sx 5 epx1,468x60,0.007018,3,1,0,0,0,0
USD,mogo perf arts sx,320x100,10.475824,697,502,1,4,0,4
USD,ttd tech sx,300x600,1297.027864,133715,103574,133,625,35,590
USD,DO NOT USE Microsoft Bin (001),300x250,6561.378246,2030237,1744165,1299,3335,347,2988
USD,DO NOT USE Tier 3 (2),240x400,0.051771,3,2,0,0,0,0
USD,Triad Stage Local sx,160x600,0.097626,2,2,0,0,0,0
USD,mogo marks branding drhbx gold sx,970x90,74.272784,6337,5585,10,11,1,10
USD,mogo marks coupon sx,320x100,0.900359,37,31,0,0,0,0
USD,mogo marks sports sx,970x90,89.603652,5387,4522,1,3,0,3
USD,mogo marks video branding max reach tail aggregate sx,240x400,0.113178,9,8,0,0,0,0
USD,mogo marks video branding medium reach tail aggregate sx,160x600,32075.26027,9550280,8525242,3815,16254,1234,15020
USD,sfoc cix sx,160x600,2.246257,94,83,0,0,0,0
USD,ttd music sx,160x600,1755.007618,704595,655606,288,1066,73,993
USD,DCPA Video black sx,300x600,8.72854,1240,1029,1,1,1,0
USD,DO NOT USE Tier 2,970x250,423.617033,36327,28933,82,95,10,85
USD,Performing Arts Fort Worth Test List,300x250,130.470979,17248,13056,18,93,10,83
USD,iab aff-im black sx,300x250,44.82376,2238,2048,3,1,0,1
USD,mogo marks branding drhbx platinum sx,160x600,689.946739,69432,61261,78,460,11,449
USD,mogo marks lal (purchase) silver sx,240x400,0.063016,5,4,0,0,0,0
USD,mogo marks lal branding (All) silver sx,320x100,225.638195,41163,38234,56,115,19,96
USD,ttd food sx,336x280,2.811054,155,146,0,0,0,0
USD,Android Top Selling Free Weather,320x100,0.691202,315,279,0,0,0,0
USD,Chicago T1 sites,970x250,246.112986,27456,20822,73,117,53,64
USD,education master sx,300x600,5590.521071,635378,536714,602,2817,209,2608
USD,mogo marks native standard reach (no) tail aggregate sx,320x50,58854.73462,13870790,12938809,17704,23169,7302,15867
USD,/All Apps/Apple App Store/Newsstand/News & Politics,320x50,0.00759,2,2,0,0,0,0
USD,/All Apps/Google Play/Games/Casino,728x90,0.234913,301,300,0,0,0,0
USD,Android Top Selling Free Music and Audio,300x250,272.746044,86705,82658,131,18,6,12
USD,DCPA video local sx,300x600,10.160209,341,285,0,3,0,3
USD,DO NOT USE All Google Anonymous (2),728x90,0.009413,10,8,0,0,0,0
USD,Mercury Theater Chicago sx,300x250,166.081344,58022,45065,55,40,25,15
USD,Mogo DBM select video sx,970x66,0.11512,23,4,0,0,0,0
USD,mogo marks agg sx xsl37589,250x250,104.42192,13403,11008,5,20,0,20
USD,mogo marks video branding medium reach tail aggregate sx,250x250,62.697216,8025,6658,5,9,0,9
USD,ttd female sx,320x50,7559.803791,2996746,2824335,1597,3470,504,2966
USD,ttd music sx,250x250,3.661823,359,316,0,1,0,1
USD,Android Top Selling Free Sports,320x50,103.164288,115050,104631,193,16,11,5
USD,Channel of Top Global Sites for Nielsen Display Ads - DO NOT EDIT,160x600,44446.45651,12015658,10669329,5164,21900,1679,20221
USD,Channel of Top US Sites for Nielsen Video Ads - DO NOT EDIT,970x90,269.155413,21422,18519,15,20,0,20
USD,DO NOT USE Tier 1,240x400,0.030607,3,2,0,0,0,0
USD,debartolo local site list,728x90,9.689707,607,373,0,7,0,7
USD,dso custom hx,320x50,85.321783,15528,14764,8,286,8,278
USD,fgu test public channel,300x250,14450.4714,3311095,2809002,1000,3504,263,3241
USD,mogo marks coupon sx,120x600,0.150891,14,8,0,0,0,0
USD,mogo marks ttd obx kitchen premium sink sx,300x50,1495.914135,263518,247812,147,4174,133,4041
USD,mogo marks xsl_74205 (2p dims) sx ,300x50,171.557463,33999,30888,17,511,19,492
USD,ttd entertainment sx,320x50,18511.99346,6702117,6206780,5233,7505,1536,5969
USD,/All Apps/Google Play/Games,300x250,278.57416,24296,21901,229,39,35,4
USD,DO_NOT_USE Bid Manager reportable sites channel (Soon to be deprecated and please exclude channel: Non-reportable sites and apps),970x90,420.233982,32170,27899,32,35,1,34
USD,kid safe sx,250x250,15.920001,2081,1647,1,2,0,2
USD,mogo marks houston sx,160x600,0.951877,131,66,0,2,0,2
USD,mogo marks native (sharethrough) unique us sx,200x200,0.647713,44,38,0,0,0,0
USD,mogo marks native sx xsl1045 class b,300x100,0.086565,13,11,0,0,0,0
USD,mogo marks native sx xsl1045 class c,970x90,91.935647,8101,6753,0,6,0,6
USD,mogo marks xsl_74205 (4p dims) sx ,300x250,24019.15261,4194097,3390457,2876,8864,903,7961
USD,/All Apps/Apple App Store/Games/Trivia,320x50,45.445159,24597,23226,19,0,0,0
USD,African American Interests sx,300x250,0.402017,57,47,0,0,0,0
USD,Greg's GG KPI + relevant sites list,970x250,1.911266,48,45,0,0,0,0
USD,Mogo MMX tabx sx,320x50,0.415067,167,158,0,0,0,0
USD,mogo marks branding drhbx platinum sx,250x250,2.422848,219,183,0,3,0,3
USD,mogo marks hq100p sx,970x66,0.175138,30,12,0,0,0,0
USD,mogo sf local sx,300x50,61.59746,5781,5373,3,86,0,86
USD,ttd beauty sx,320x100,0.869594,45,41,0,0,0,0
USD,tz - Local Seattle sx,320x50,9.168137,5195,4053,2,5,0,5
USD,zt perf arts black sx 5,160x600,0.093975,27,25,0,1,0,1
USD,/All Apps/Apple App Store/Games/Family,160x600,0.212117,9,9,1,0,0,0
USD,DO NOT USE Tier 3* (CHANNEL),320x50,35841.51816,10352420,9586956,10357,13625,2872,10753
USD,Nashville Local sx,728x90,5.232512,606,573,0,5,0,5
USD,arizona opera top converters sx,160x600,38.779357,7324,6932,2,7,2,5
USD,maryland-dc sx,160x600,41.542626,10084,7890,4,7,2,5
USD,mogo marks branding tier 2 sx xls37852,970x66,0.780627,238,139,0,0,0,0
USD,mogo marks lal branding (All) silver sx,120x600,4.826004,573,452,0,0,0,0
USD,mogo marks natl cat-aff-im sx 2,250x250,1.635342,143,126,0,0,0,0
USD,mogo marks perf arts sx 6,300x50,1.091246,77,71,0,4,0,4
USD,mogo mba tier 2 sx,320x100,1.407745,130,124,1,0,0,0
USD,/All Apps/Google Play/Games/Racing,336x280,0.005894,2,2,0,0,0,0
USD,mogo marks native (sharethrough) unique us sx,250x250,11.706519,1616,1392,2,1,0,1
USD,mogo marks pav kpi sx 2,970x250,5170.113016,472934,403043,778,1932,411,1521
USD,mogo marks perf arts sx 6,336x280,0.822517,32,24,0,1,0,1
USD,sfoc pslx 2019 sx (Mar_2019),970x250,368.372134,52744,48495,85,405,73,332
USD,ttd real estate sx,300x250,825.25948,261503,48029,32,270,11,259
USD,/All Apps/Apple App Store/Games/Casino,160x600,149.079982,2920,2809,504,10,10,0
USD,/All Apps/Apple App Store/Newsstand/Regional News,970x90,0.008705,5,5,0,0,0,0
USD,/All Apps/Google Play/Media & Video,336x280,0.042636,4,4,0,0,0,0
USD,APACTix Sitelist sx,728x90,54.388865,1860,1412,2,10,0,10
USD,Diablo Blacklist ,300x600,3.104734,235,219,0,11,0,11
USD,finn dallas native sx,300x250,2107.625149,156271,116316,195,726,72,654
USD,mogo CBS Interactive sx,300x250,1078.468499,148253,98252,95,467,45,422
USD,mogo lydia peacecenter test,320x100,0.29381,38,34,0,0,0,0
USD,mogo marks elite kpi achievers sx,300x250,10048.46343,1432806,1001929,1355,3416,449,2967
USD,mogo marks perf arts sx 11,336x280,0.822517,32,24,0,1,0,1
USD,Channel of Top non-US Sites for Nielsen Display Ads - DO NOT EDIT,320x100,183.731628,27096,25378,33,77,14,63
USD,DO NOT USE Tier 2* (CHANNEL),300x600,5158.838861,576921,515648,471,2455,161,2294
USD,/All Apps/Google Play/Books & Reference,160x600,0.127773,4,4,0,0,0,0
USD,/All Apps/Google Play/Games/Board,300x50,0.063649,51,51,0,0,0,0
USD,Android Top Selling Free Health and Fitness,300x250,5.858793,503,304,5,2,1,1
USD,Android Top Selling Free Social,300x600,10.334001,790,694,29,4,4,0
USD,mogo financial services kpi sx,160x600,5152.049908,1374336,1164369,446,1563,164,1399
USD,mogo marks broadway sx,320x50,1418.894214,105984,95600,166,861,76,785
USD,mogo marks native (sharethrough) unique can sx,728x90,11912.64813,2442029,2141783,970,6702,318,6384
USD,mogo marks natl elite cat-aff-im sx,300x250,10295.96952,1316460,1055624,1450,3989,532,3457
USD,mogo marks perf arts platinum sx,320x50,1570.112701,131877,107691,199,930,95,835
USD,mogo marks stratford (canada) sx,320x50,0.024178,2,1,0,0,0,0
USD,ttd weather sx,970x250,321.604026,13367,10535,56,94,8,86
USD,/All Apps/Apple App Store/Finance,300x250,2.85358,350,297,0,0,0,0
USD,/All Apps/Google Play/Education,728x90,0.812636,623,609,1,0,0,0
USD,/All Apps/Google Play/Entertainment,336x280,0.000748,1,1,0,0,0,0
USD,/All Apps/Google Play/Finance,970x250,0.000904,16,16,0,0,0,0
USD,5a local sx seattle,160x600,0.022532,22,22,0,0,0,0
USD,DO NOT USE AppNexus - Collective Media,320x50,32624.66491,7089460,6620350,10686,13372,5035,8337
USD,Mogo DBM premium video sx,336x280,11.540535,949,847,0,1,0,1
USD,mogo biz-fi sx,320x50,1347.805149,278462,250155,205,482,83,399
USD,mogo marks bwwpb sx,320x50,1140.955758,77230,70340,144,678,66,612
USD,mogo marks native sx xsl1045 class a,160x600,297.862449,34585,27694,21,159,2,157
USD,mogo marks wsj sx x4v,300x250,310.108842,9193,7941,19,68,7,61
USD,mogo marks xsl_ks20780 sx,300x100,2.84024,565,499,1,0,0,0
USD,Lynn Grad,320x50,98.142021,14348,13542,11,49,4,45
USD,mogo canada t1 sx,300x50,61.760174,10809,10336,5,134,6,128
USD,mogo marks native sx xsl1045 class b,336x280,2.031799,188,158,0,0,0,0
USD,pac motorsports sx,300x250,14352.16041,3277620,2821010,994,3024,262,2762
USD,mogo marks branding comp rate platinum video sx,300x250,42808.0198,8920443,7411232,5118,13275,1508,11767
USD,mogo marks perf arts sx 7,300x50,10.70704,1062,991,2,20,1,19
USD,mogo marks video branding medium reach tail aggregate sx,970x90,250.130526,20096,17347,24,20,0,20
USD,DO NOT USE Android Top Selling Free Media and Video,300x250,0.580946,61,50,0,0,0,0
USD,DO NOT USE Tier 2* (CHANNEL),320x50,9612.850759,2554521,2373747,2458,4306,633,3673
USD,DSM African American sx,160x600,0.38048,64,51,0,1,0,1
USD,Performing Arts Fort Worth Test List,970x250,15.36674,1522,1300,6,7,3,4
USD,mogo marks dallas sx,300x50,2.18461,436,411,0,3,0,3
USD,mogo marks disney sx,970x90,2.121977,80,74,0,0,0,0
USD,mogo marks kpi mdx sx xls9297,320x100,30.276505,8077,7628,6,25,1,24
USD,mogo marks perf arts sx 2,300x250,11283.80536,1352407,1055723,1523,3719,532,3187
USD,mogo marks perf arts sx 6,250x250,0.019762,6,1,0,0,0,0
USD,mogo marks phoenix sx,300x50,0.766226,185,173,0,0,0,0
USD,mogo marks xsl_800p sx,970x66,0.585214,328,35,0,0,0,0
USD,ttd real estate sx,728x90,104.51291,18531,3663,2,23,1,22
USD,/All Apps/Apple App Store/Finance,728x90,27.425877,1474,1405,11,0,0,0
USD,/All Apps/Apple App Store/Games/Action,160x600,0.010459,1,1,0,0,0,0
USD,Android Top Selling Free Health and Fitness,728x90,0.077851,28,23,0,0,0,0
USD,RCU Blacklist Sites (CPA),300x600,1.436066,151,133,0,1,0,1
USD,mogo marks lal branding (All) gold sx,468x60,3.305409,1068,529,0,0,0,0
USD,mogo marks travel sx,300x600,367.102963,11558,9962,19,142,1,141
USD,mogo marks wsj sx x4v,728x90,147.863248,3819,3212,6,12,2,10
USD,ttd music sx,970x90,0.469379,89,72,1,0,0,0
USD,Android Top Selling Free Social,320x50,462.837226,154718,139274,496,36,29,7
USD,mogo marks natl elite cat-aff-im sx,728x90,6304.403802,514583,412280,240,2116,89,2027
USD,mogo marks perf arts platinum sx,336x280,0.888875,35,27,0,2,0,2
USD,mogo marks perf arts sx 11,250x250,0.009307,5,0,0,0,0,0
USD,mogo sf local sx,250x250,0.279094,25,21,0,0,0,0
USD,ttd entertainment sx,320x51,0.8361,20,19,0,0,0,0
USD,ttd news sx,728x90,19431.03131,4033169,2912272,1546,6144,643,5501
USD,/All Apps/Apple App Store/Social Networking,160x600,0.020936,2,1,0,0,0,0
USD,/All Apps/Google Play/News & Magazines,300x600,32.867704,2060,1855,18,3,3,0
USD,DO NOT USE Mobile - MoPub - Sports,320x50,0.010284,5,3,0,0,0,0
USD,mogo marks branding tier 1 sx xls37852,200x200,2.056039,261,200,0,1,0,1
USD,mogo marks coupon sx,320x50,91.156987,8180,6663,5,12,1,11
USD,mogo marks ttd obx kitchen premium sink sx,970x250,10174.99875,1298859,1134158,1876,3399,699,2700
USD,ttd education sx,200x200,0.150526,14,14,0,0,0,0
USD,ttd travel sx,300x600,3601.853877,172957,149619,443,925,107,818
USD,/All Apps/Apple App Store/Utilities,300x600,1.261311,123,110,6,1,1,0
USD,/All Apps/Google Play/Comics,320x50,0.646355,1049,1005,0,0,0,0
USD,DO NOT USE Mobile - MoPub - Beauty & Fitness/Fitness,320x50,12.455693,6802,6667,5,1,1,0
USD,DO NOT USE OAM UK,728x90,219.855116,38061,16442,24,72,5,67
USD,DO NOT USE Tier 2* (CHANNEL),300x100,0.185068,46,42,0,0,0,0
USD,mogo marks denver sx,300x250,1230.493595,123873,106818,79,346,48,298
USD,mogo marks native (sharethrough) unique can sx,300x50,358.695104,85049,80895,37,851,27,824
USD,pac canada sports sx,468x60,0.304143,226,146,0,0,0,0
USD,ttd gaming sx,320x100,3.578701,609,546,3,0,0,0
USD,/All Apps/Apple App Store/Navigation,300x250,2.486136,133,120,1,0,0,0
USD,Mogo DBM basic video sx,160x600,219.446383,37132,30086,24,124,7,117
USD,dso kpi audx sx,300x600,11.530044,630,580,0,11,0,11
USD,mogo marks lal branding (All) silver sx,320x50,55180.64999,10579529,9821752,14599,23927,6234,17693
USD,mogo marks natl cat-aff-im sx,300x50,120.992749,14976,14368,9,257,7,250
USD,mogo marks outbound kpi sx x1a,728x90,6647.846927,512302,395498,285,1353,93,1260
USD,mogo marks pav kpi sx 3,300x600,1053.959593,80379,68646,82,553,41,512
USD,mogo perf arts sx,320x50,1850.054795,368175,320374,239,887,94,793
USD,mogo t1 brand sx,970x250,6387.385502,854117,756852,1163,2061,423,1638
USD,/All Apps/Google Play/Tools,320x100,0.061984,63,63,0,0,0,0
USD,Android Top Selling Free Weather,320x50,2274.891337,791566,733826,919,285,203,82
USD,BR Native sx,300x600,77.100226,8681,8000,9,33,1,32
USD,Brandcast Blacklist ,300x250,19194.5966,5615179,4797588,1634,7515,428,7087
USD,GG KPI sx,300x600,143.593735,5371,4925,4,1,0,1
USD,mogo marks video branding max reach tail aggregate sx,250x250,70.65664,8780,7275,5,10,0,10
USD,mogo marks xsl_74205 (2p dims) sx ,728x90,10685.6532,1469047,1074256,1216,3984,199,3785
USD,/All Apps/Apple App Store,320x100,1.184965,596,479,0,0,0,0
USD,/All Apps/Google Play/Music & Audio,300x250,290.803762,94394,91453,130,13,2,11
USD,Channel of Top Global Sites for Nielsen Display Ads - DO NOT EDIT,970x66,1.092516,334,158,0,0,0,0
USD,DO NOT USE fgu test public channel,250x250,0.970798,270,219,0,0,0,0
USD,mogo marks branding elite tier sx xls37852,120x600,0.150891,14,8,0,0,0,0
USD,mogo marks broadwayworld sx,468x60,0.004844,2,0,0,0,0,0
USD,mogo marks native high reach tail aggregate sx,120x600,4.370038,746,549,0,0,0,0
USD,/All Apps/Google Play,300x600,1063.434531,41558,37473,1315,315,290,25
USD,/All Apps/Google Play/Games/Arcade,336x280,0.11592,27,13,0,2,2,0
USD,/All Apps/Google Play/Lifestyle,300x50,1.976382,465,430,1,0,0,0
USD,mogo marks native (sharethrough) unique us sx,468x60,0.348965,130,109,0,0,0,0
USD,sfoc kpi sx (acquisition 2019),300x600,494.140651,62316,57558,92,788,104,684
USD,DO NOT USE AppNexus - Collective Media,970x90,41.367442,4118,3454,3,3,0,3
USD,DO NOT USE Tier 1,320x50,44420.30954,10347599,9631837,14406,17500,5891,11609
USD,Diablo DVC Shortlist (Advertiser Level),300x600,407.751934,23353,21466,27,4092,93,3999
USD,mogo black rt sx,300x600,1.897864,502,374,0,0,0,0
USD,mogo marks branding max reach sx,320x100,438.983839,67424,62190,112,244,32,212
USD,mogo marks chicago sx,250x250,0.478339,55,51,0,0,0,0
USD,mogo marks perf arts branding high reach sx,728x90,2047.996703,209808,164205,99,779,34,745
USD,mogo marks sacramento sx,728x90,375.448578,144563,130808,31,220,12,208
USD,mogo marks xsl_800p sx,300x600,42915.03963,5159028,4261416,4404,19905,1656,18249
USD,/All Apps/Apple App Store/Weather,300x250,24.712301,4086,3021,10,0,0,0
USD,Channel of Top Global Sites for Nielsen Display Ads - DO NOT EDIT,336x280,148.076804,24558,21291,20,34,0,34
USD,mogo marks lal (purchase) gold sx,970x250,5979.60416,401607,331565,783,1975,373,1602
USD,/All Apps/Apple App Store/Games/Board,320x100,0.007964,5,5,0,0,0,0
USD,mogo marks high intenders sx,300x100,0.056246,19,17,0,0,0,0
USD,mogo marks pav kpi sx,160x600,1481.109646,82764,59540,60,453,23,430
USD,mogo marks perf arts platinum sx,970x90,0.519304,25,22,0,0,0,0
USD,mogo marks toronto sx,728x90,865.605941,118487,106772,64,719,17,702
USD,mogo marks video branding max reach tail aggregate sx,300x600,40886.24978,4869539,4057061,4801,17780,1799,15981
USD,mogo marks ballet sx,300x50,0.135513,6,6,0,0,0,0
USD,ttd health wellness sx,320x100,6.634985,1347,1244,1,3,0,3
USD,/All Apps/Google Play/Games/Music,300x250,0.597435,76,66,1,0,0,0
USD,/All Apps/Google Play/Personalization,300x50,0.065616,12,10,0,0,0,0
USD,DCPA rt black sx,300x250,84.327426,4494,4099,7,13,0,13
USD,DO NOT USE Invite US Expandable Enabled Sites,160x600,1271.656748,657915,576787,137,570,41,529
USD,DO NOT USE Tier 3 (2),300x50,62.015719,11579,10804,3,146,4,142
USD,mogo black sx,468x60,0.159118,123,108,0,0,0,0
USD,mogo marks kpi mdx sx xls9297,120x600,0.387804,23,17,0,0,0,0
USD,mogo marks video branding extended reach tail aggregate sx,320x100,221.517021,37839,35474,78,100,24,76
USD,t1 brand black sx,300x250,19.001573,504,466,0,0,0,0
USD,ttd real estate sx,300x600,117.708257,5028,4245,6,25,1,24
USD,/All Apps/Apple App Store/Finance,300x600,0.434844,8,8,0,0,0,0
USD,Android Top Selling Free Tools,970x250,0.036651,7,6,0,0,0,0
USD,SP News Black sx,160x600,0.52624,27,7,0,0,0,0
USD,mogo education sx,160x600,844.479475,194086,177244,100,444,39,405
USD,mogo marks lal branding (All) platinum sx,300x50,206.935234,16883,16004,13,577,9,568
USD,mogo marks ttd obx kitchen premium sink sx,336x280,35.26991,4340,3781,0,10,0,10
USD,mogo marks wsj sx x4v,300x600,628.300911,15591,13837,41,193,13,180
USD,mogo marks xsl_74205 (2p dims) sx ,336x280,13.561684,994,911,0,3,0,3
USD,mogo marks xsl_74205 (4p dims) sx ,200x200,0.014553,1,0,0,0,0,0
USD,mogo CBS Interactive sx,300x600,248.26907,10669,9634,27,113,3,110
USD,mogo marks houston sx,970x90,0.077416,12,9,0,0,0,0
USD,mogo marks native (sharethrough) unique can sx,320x50,24265.56075,7249293,6752823,7259,8196,1891,6305
USD,mogo marks natl elite cat-aff-im sx,300x600,1707.32743,101326,83380,111,635,46,589
USD,mogo t1 brand sx,336x280,13.578731,1507,1338,0,1,0,1
USD,Android Top Selling Free Health and Fitness,300x600,13.982785,522,486,10,0,0,0
USD,Pac Fox Atlanta EXCLUSION List,300x50,7.803136,3330,3194,0,41,0,41
USD,mogo marks lal (purchase) silver sx,300x50,1382.861734,160811,152887,104,4143,67,4076
USD,mogo marks philadelphia sx,970x90,0.010114,1,0,0,0,0,0
USD,mogo marks sacramento sx,970x66,0.026533,6,2,0,0,0,0
USD,sfjazz travel sx,320x50,269.69863,25329,23838,306,401,328,73
USD,/All Apps/Google Play/Games/Casual,300x50,2.664258,525,503,6,0,0,0
USD,APACTix Sitelist sx,320x50,169.98505,6585,5481,5,14,0,14
USD,Android Top Selling Free Entertainment,320x100,0.056865,128,108,1,0,0,0
USD,Channel of Top non-US Sites for Nielsen Display Ads - DO NOT EDIT,970x250,8597.348439,1003278,881816,1469,3101,463,2638
USD,mogo lydia peacecenter test,970x250,5623.149093,779850,698318,1026,1735,336,1399
USD,mogo marks wedding sx,468x60,0.002216,1,0,0,0,0,0
USD,pac motorsports sx,468x60,0.00964,2,0,0,0,0,0
USD,/All Apps/Apple App Store/Games/Board,728x90,1173.539453,436072,420800,1988,184,174,10
USD,Provident High CTR List ,300x250,3007.341046,201527,187872,253,2,0,2
USD,bbb kpi sx (2019),300x600,71.193667,5482,5072,3,92,0,92
USD,mogo marks branding drhbx platinum sx,970x90,28.004663,1457,1233,2,5,0,5
USD,mogo marks video branding extended reach tail aggregate sx,970x90,140.466223,11861,10224,11,13,0,13
USD,mogo marks wedding sx,300x250,50.733106,4015,3150,0,25,0,25
USD,zt local austin sx,160x600,3.255903,738,574,0,1,0,1
USD,/All Apps/Apple App Store/Music,160x600,0.053331,5,3,1,0,0,0
USD,/All Apps/Google Play/Games/Educational,320x50,1.376404,2231,2173,3,4,3,1
USD,DO NOT USE Tier 3,120x600,5.586385,1298,923,1,0,0,0
USD,DO NOT USE Tier 3* (CHANNEL),240x400,0.109962,11,6,0,0,0,0
USD,Duxiana - KPI sx,320x50,5131.646725,552407,514335,2020,1109,1075,34
USD,PAC Singapore Rugby sx,970x250,0.674115,27,22,0,0,0,0
USD,Stratford KPI revised,320x50,87.343432,23538,22389,21,108,16,92
USD,mogo marks branding max reach sx,320x50,121297.668,34413434,31650660,35738,48583,12269,36314
USD,mogo marks pav kpi sx 3,320x100,0.61088,81,57,0,0,0,0
USD,mogo marks xsl_74205 sx ,300x100,0.036278,9,9,0,0,0,0
USD,mogo marks xsl_ks0001 sx,250x250,71.210788,8820,7275,1,12,0,12
USD,mogo music sx,300x600,144.045944,11691,9591,9,56,4,52
USD,mogo sports sx,250x250,0.931577,119,82,0,0,0,0
USD,/All Apps/Google Play/News & Magazines,320x100,0.01928,18,15,0,0,0,0
USD,Android Top Selling Free Travel and Local,300x50,0.08987,60,54,0,0,0,0
USD,DO NOT USE Invite US Expandable Enabled Sites,300x600,536.255144,69660,55980,68,194,17,177
USD,Stratford Black RT SX,160x600,0.115007,14,14,0,0,0,0
USD,mogo black sx,300x250,2797.024843,408610,336003,331,942,75,867
USD,mogo education sx,300x600,367.4804,55301,48305,42,298,8,290
USD,mogo marks branding tier 1 sx xls37852,250x250,56.855975,8051,6590,4,9,0,9
USD,mogo marks dallas sx,300x250,573.802502,86393,63698,58,126,21,105
USD,mogo marks high intenders sx,160x600,225.431358,35330,28312,21,134,5,129
USD,mogo marks ticketing sx,250x250,0.111509,12,12,0,0,0,0
USD,ttd family parent sx,468x60,0.020049,8,6,0,0,0,0
USD,ttd health wellness sx,320x50,5114.237144,864659,818451,700,2822,263,2559
USD,/All Apps/Apple App Store/Games/Board,320x50,419.897685,297401,289499,676,18,10,8
USD,/All Apps/Apple App Store/Reference,300x250,0.33152,93,60,1,0,0,0
USD,DO NOT USE Tier 3,300x50,843.068452,168269,158413,83,2633,86,2547
USD,Mogo DBM select video sx,468x60,0.009723,1,1,0,0,0,0
USD,mogo biz-fi sx,336x280,1.577829,65,56,0,0,0,0
USD,mogo marks broadway sx,336x280,0.851669,34,26,0,1,0,1
USD,mogo marks broadwayworld sx,300x50,0.208093,5,3,0,0,0,0
USD,mogo marks perf arts gold sx,970x66,0.004991,1,0,0,0,0,0
USD,mogo marks xsl_ks20780 sx,120x600,10.620506,2688,2124,2,0,0,0
USD,ttd shopping sx,300x50,48.81056,4803,4549,2,206,2,204
USD,DCPA rt black sx,160x600,4.074506,339,270,1,0,0,0
USD,DO NOT USE All Google Anonymous,468x60,0.004182,1,1,0,0,0,0
USD,DO NOT USE AppNexus - Collective Media,336x280,8.799118,2408,1978,3,0,0,0
USD,Nashville Symphony black list all adgroups,970x250,7.762586,333,291,0,9,0,9
USD,iab aff-im black sx,970x250,5.075992,237,219,1,0,0,0
USD,mogo marks bwwpb sx,336x280,0.743167,30,22,0,1,0,1
USD,mogo marks pav kpi hx,300x250,23066.60513,4534383,3589289,2927,8388,907,7481
USD,mogo marks wine sx,160x600,3.189858,178,151,1,1,1,0
USD,pac canada sports sx,300x50,87.081967,20832,19656,19,63,6,57
USD,/All Apps,300x600,2789.272105,151509,124193,7893,1269,1172,97
USD,Android Top Selling Free Social,320x100,0.001854,6,6,0,0,0,0
USD,Cal Perf KPI sx ,728x90,831.216806,136541,67709,22,22,0,22
USD,ttd auto sx,970x250,20.295945,1332,1069,1,3,0,3
USD,ttd shopping sx,728x90,2373.896792,289519,219707,167,956,46,910
USD,ttd tech sx,336x280,3.204403,299,268,0,5,0,5
USD,/All Apps/Google Play/Games/Sports,970x250,0.039905,1,1,0,0,0,0
USD,Channel of Top Global Sites for Nielsen Video Ads - DO NOT EDIT,970x250,9833.053413,1230874,1068502,1799,3408,620,2788
USD,DO NOT USE Spanish Language Sites,300x250,416.516159,102432,90990,48,302,10,292
USD,DO NOT USE Tier 3* (CHANNEL) (2),120x600,0.245941,119,107,0,0,0,0
USD,LSSU url v1,728x90,34.194963,7530,7139,4,78,2,76
USD,education master sx,336x280,13.724288,1473,1288,0,1,0,1
USD,mogo marks kpi achievers sx,300x250,11033.15078,1362143,1023325,1471,3774,501,3273
USD,tz - Local Seattle sx,160x600,0.032781,4,3,0,0,0,0
USD,GG KPI sx,970x90,1.452966,32,30,0,0,0,0
USD,Mogo DBM basic video sx,970x250,61.775988,10158,8400,34,22,4,18
USD,mogo marks lal (purchase) platinum sx,250x250,1.318557,88,73,0,1,0,1
USD,mogo marks native standard reach (no) tail aggregate sx,250x250,34.174322,4309,3515,4,6,0,6
USD,mogo marks perf arts sx 5 epx1,320x50,2051.749733,226950,193283,236,1089,108,981
USD,mogo mba tier 2 sx,300x100,0.097726,20,17,0,0,0,0
USD,ttd news sx,970x66,0.085634,22,7,0,0,0,0
USD,Pac Private Events/Wedding sx,300x600,102.116351,5745,3492,5,25,0,25
USD,mogo marks t1 brand sx trim,320x100,58.518651,12971,11770,26,50,7,43
USD,/All Apps/Apple App Store/News,300x600,191.720529,24393,18519,292,1,0,1
USD,Brandcast Blacklist ,970x90,4.560779,504,469,0,1,0,1
USD,DO NOT USE Mobile - MoPub - Online Communities,300x600,4.361284,193,163,4,1,1,0
USD,DO NOT USE Tier 3,600x250,0.000272,1,0,0,0,0,0
USD,DO NOT USE Tier 3* (CHANNEL),160x600,13876.17428,3556050,3075499,1713,6943,434,6509
USD,NYPR whitelist sx (Advertiser Level),300x600,40.981667,843,769,0,3,0,3
USD,dbm video sx,120x600,0.437146,40,34,0,0,0,0
USD,mogo centro sx US (2014),160x600,831.30695,140116,125176,90,348,22,326
USD,mogo marks branding increased reach sx,336x280,165.292236,20804,17799,13,59,0,59
USD,mogo marks native sx xsl1045 class c,120x600,0.108107,36,29,0,0,0,0
USD,finn dallas native sx,970x90,0.090944,9,5,0,0,0,0
USD,mogo marks elite kpi achievers sx,970x90,26.446373,1807,1565,1,4,0,4
USD,mogo marks xsl_74205 (2p dims) sx ,468x60,0.006997,3,1,0,0,0,0
USD,mogo mba tier 2 sx,300x600,4246.318714,381008,327845,321,1749,147,1602
USD,ttd auto sx,336x280,0.301902,45,38,0,0,0,0
USD,/All Apps/Google Play/Entertainment,160x600,0.035362,3,3,0,0,0,0
USD,bbb kpi sx (2019),970x250,34.666664,1211,1099,3,8,0,8
USD,mogo black sx,320x100,5.745943,942,883,3,0,0,0
USD,mogo marks video sx xsl44760 class b,970x90,8.480291,412,314,0,0,0,0
USD,/All Apps/Apple App Store/Weather,320x50,881.075015,186786,166001,273,8,4,4
USD,/All Apps/Google Play/Medical,300x600,0.015985,2,2,0,0,0,0
USD,DO NOT USE Invite US Expandable Enabled Sites,970x250,132.798211,20990,18230,25,34,9,25
USD,Mogo DBM premium video sx,160x600,3727.248821,960094,911277,294,893,101,792
USD,mogo education sx,970x250,136.180386,5116,4544,31,55,6,49
USD,mogo marks outbound kpi sx x1a,468x60,0.514759,171,154,0,0,0,0
USD,mogo marks perf arts sx 5 epx1,200x200,0.034542,3,2,0,0,0,0
USD,mogo t1 brand sx,468x60,0.526249,258,178,0,0,0,0
USD,Channel of Top Global Sites for Nielsen Video Ads - DO NOT EDIT,336x280,91.038875,20937,18228,24,18,0,18
USD,Mogo DBM basic video sx,336x280,3.035558,796,649,3,0,0,0
USD,Mogo DBM select video sx,120x600,0.017775,1,1,0,0,0,0
USD,Mogo dating sx,300x600,4.982602,1015,857,1,18,10,8
USD,mogo marks perf arts sx 11,160x600,1267.325564,74087,50487,56,415,25,390
USD,mogo marks wsj sx x4v,970x90,0.68211,38,33,0,0,0,0
USD,mogo music sx,970x250,20.711586,1665,1452,3,7,3,4
USD,mogo sf local sx,160x600,37.76214,6086,3699,3,10,0,10
USD,ttd beauty sx,300x600,436.255525,48229,43639,27,264,7,257
USD,/All Apps/Google Play/Games/Sports,336x280,0.005003,2,2,0,0,0,0
USD,Cal Performances sf local + t1 brand black sx,160x600,0.01012,2,2,0,0,0,0
USD,ttd family parent sx,120x600,0.071216,22,21,0,0,0,0
USD,/All Apps/Google Play/Games/Action,160x600,0.013599,2,2,0,0,0,0
USD,/All Apps/Google Play/Games/Word,970x250,1.159524,114,80,1,1,1,0
USD,/All Apps/Google Play/Medical,300x50,0.026119,13,13,0,0,0,0
USD,DCPA video local sx,160x600,0.233209,13,11,0,0,0,0
USD,DO_NOT_USE Bid Manager reportable sites channel (Soon to be deprecated and please exclude channel: Non-reportable sites and apps),320x100,423.882609,67055,61767,107,238,32,206
USD,Pac Private Events/Wedding sx,728x90,76.202759,8329,6881,2,39,0,39
USD,dbm video sx,970x250,6944.607138,852288,748879,1199,2439,464,1975
USD,mogo centro sx US (2014),970x66,0.03945,12,2,0,0,0,0
USD,mogo marks lal (purchase) platinum sx,160x600,2232.296461,149303,114596,129,1130,48,1082
USD,mogo marks opera sx,320x50,0.030935,10,4,0,0,0,0
USD,mogo marks xsl_74205 sx ,728x90,11022.66944,1508184,1106768,1234,4200,219,3981
USD,ttd kids sx,970x90,5.877796,209,196,0,1,0,1
USD,Channel of Top Global Sites for Nielsen Display Ads - DO NOT EDIT,300x250,165209.6888,35884151,28718199,18423,62763,4930,57833
USD,DO NOT USE Spanish Language Sites,728x90,124.097479,18072,15713,16,42,9,33
USD,education master sx,250x250,8.43519,877,741,0,1,0,1
USD,mogo marks kpi achievers sx,728x90,6647.846927,512302,395498,285,1353,93,1260
USD,mogo marks travel sx,320x100,0.386133,28,25,0,0,0,0
USD,/All Apps/Apple App Store/News,320x50,837.581073,727321,676390,839,29,15,14
USD,/All Apps/Google Play/Games/Simulation,300x600,27.072672,796,728,25,3,3,0
USD,DO NOT USE Rubicon,970x90,1.965159,193,143,0,0,0,0
USD,NYPR whitelist sx (Advertiser Level),728x90,23.184936,493,467,0,0,0,0
USD,Pac Private Events/Wedding sx,320x50,104.377962,38435,36058,16,87,4,83
USD,mogo marks branding drhbx gold sx,300x250,24555.55751,3168693,2378931,2634,10621,864,9757
USD,mogo marks xsl_74205 sx ,320x50,15934.4653,4067259,3635806,4463,6354,1285,5069
USD,ttd finance sx,970x250,4802.44817,386946,332873,695,1424,316,1108
USD,/All Apps,320x50,11465.58091,5880135,5535051,9751,923,556,367
USD,/All Apps/Apple App Store/Games,320x100,0.007964,5,5,0,0,0,0
USD,Channel of Top non-US Sites for Nielsen Display Ads - DO NOT EDIT,468x60,6.978097,3220,2224,0,0,0,0
USD,DO NOT USE Mobile - MoPub - Online Communities,320x50,88.475267,59253,55430,76,3,1,2
USD,NYPR whitelist sx (Advertiser Level),320x50,139.427921,3987,3787,10,1,0,1
USD,mogo lydia peacecenter test,468x60,0.034793,1,1,0,0,0,0
USD,mogo marks branding increased reach sx,250x250,104.007361,13302,10978,5,19,0,19
USD,mogo marks email sx,160x600,11866.10883,2981488,2653886,1347,3331,504,2827
USD,mogo marks native sx xsl1045 class c,970x250,1189.161184,379737,348815,467,516,63,453
USD,mogo marks pav kpi hx,970x66,0.004991,1,0,0,0,0,0
USD,mogo marks perf arts sx 2,970x66,0.004991,1,0,0,0,0,0
USD,/All Apps/Apple App Store/Games/Sports,300x600,0.814978,111,100,12,1,1,0
USD,Channel of Top US Sites for Nielsen Video Ads - DO NOT EDIT,320x100,343.536143,55591,51423,95,172,30,142
USD,DO NOT USE Tier 3* (CHANNEL) (2),970x250,31.389014,3873,3161,7,18,1,17
USD,mogo marks opera sx,728x90,3.046242,457,253,1,1,0,1
USD,mogo marks seattle sx,300x600,110.842485,11058,9111,12,9,3,6
USD,mogo marks video sx xsl44760 class a,336x280,0.09683,2,2,0,0,0,0
USD,ttd tech sx,250x250,1.890382,255,169,1,0,0,0
USD,/All Apps/Apple App Store/Games/Arcade,970x250,0.096916,6,5,0,0,0,0
USD,/All Apps/Google Play/Games/Racing,728x90,0.852813,960,901,4,0,0,0
USD,CST KPI List,300x600,7.385507,3882,3052,8,8,5,3
USD,mogo marks natl cat-aff-im sx 3,160x600,1663.533361,139990,106717,95,667,37,630
USD,mogo marks perf arts sx 5 rx1,300x50,1.732987,167,146,0,6,0,6
USD,mogo marks perf arts sx 6,728x90,1552.928322,160086,118821,77,398,31,367
USD,mogo sports sx,970x250,579.511762,32893,27463,76,166,9,157
USD,ocfta perf arts black sx 5,300x250,0.137117,18,17,0,0,0,0
USD,/All Apps/Apple App Store/Book,320x50,137.138347,70195,67947,153,1,0,1
USD,/All Apps/Apple App Store/Education,320x100,0.719664,349,275,0,0,0,0
USD,Channel of Top Global Sites for Nielsen Video Ads - DO NOT EDIT,468x60,5.620299,2238,1217,0,0,0,0
USD,mogo marks classical music sx,320x50,87.166457,9133,7643,7,29,3,26
USD,mogo marks jazz & blues sx,320x51,0.8361,20,19,0,0,0,0
USD,mogo marks lal branding (All) gold sx,970x90,115.951391,6436,5545,11,11,0,11
USD,mogo marks pav kpi hx,200x200,0.144044,10,10,0,0,0,0
USD,mogo marks perf arts branding high reach sx,468x60,0.004844,2,0,0,0,0,0
USD,provident shortlist ,120x600,0.986554,405,316,0,0,0,0
USD,ttd food sx,200x200,0.07519,6,6,0,0,0,0
USD,/All Apps/Google Play/Games/Racing,320x50,2.886366,5169,4542,21,3,2,1
USD,/All Apps/Google Play/Media & Video,728x90,0.235283,645,635,1,0,0,0
USD,DO NOT USE Tier 1* (CHANNEL),970x66,0.409152,94,25,0,0,0,0
USD,mogo marks branding max reach sx,300x100,3.611375,711,631,1,0,0,0
USD,mogo marks perf arts sx 11,728x90,460.405801,36491,20192,36,160,16,144
USD,mogo sf local sx,728x90,2029.119744,327914,171471,68,712,13,699
USD,pac esports sx,160x600,233.058601,88203,68925,21,145,6,139
USD,ttd auto sx,468x60,0.236923,57,42,0,0,0,0
USD,/All Apps/Google Play/Games/Role Playing,970x250,0.005204,2,2,0,0,0,0
USD,Channel of Top US Sites for Nielsen Display Ads - DO NOT EDIT,300x50,3686.10839,759427,720079,334,9278,242,9036
USD,DO NOT USE Invite December Brand Safe List,336x280,32.546556,3395,2883,1,14,0,14
USD,DO NOT USE Tier 3 (2),250x250,4.469069,562,460,0,0,0,0
USD,mogo marks branding tier 1 sx xls37852,970x250,10011.63894,1275029,1115203,1874,3484,711,2773
USD,mogo marks detroit sx,300x600,148.579045,13969,12145,13,74,3,71
USD,mogo marks native sx xsl1045 class b,300x250,15921.86987,3849352,3219823,2184,6632,585,6047
USD,mogo marks ttd obx kitchen premium sink sx,600x250,0.000272,1,0,0,0,0,0
USD,mogo universal rt+ob black sx,160x600,7.104936,489,456,3,4,2,2
USD,provident shortlist ,300x50,906.008568,164820,155012,94,2310,88,2222
USD,sfoc marks lal custom sx,300x600,2.278102,130,114,1,1,1,0
USD,ttd education sx,320x100,85.646677,11062,10468,17,19,10,9
USD,/All Apps/Google Play/Entertainment,728x90,9.710581,10708,10608,5,0,0,0
USD,Chicago T1 sites,320x50,57.76195,48854,39880,35,35,20,15
USD,Mogo DBM basic video sx,468x60,0.305289,104,75,0,0,0,0
USD,Mogo DBM premium video sx,320x50,22816.73776,4129627,3851506,7181,9550,4094,5456
USD,Mogo DBM premium video sx,728x90,20302.07704,3379431,2503973,1958,11566,607,10959
USD,Pac Fox Atlanta EXCLUSION List,250x250,0.876037,176,162,0,0,0,0
USD,mogo marks branding drhbx gold sx,970x66,0.179517,44,11,0,0,0,0
USD,mogo marks denver sx,250x250,0.542429,11,11,0,0,0,0
USD,mogo marks lal branding (All) platinum sx,250x250,4.730379,474,403,0,1,0,1
USD,mogo marks pav kpi sx 2,300x50,78.404411,11350,10911,10,200,8,192
USD,mogo marks perf arts sx 2,200x200,0.066073,7,6,0,0,0,0
USD,mogo marks xsl_ks0001 sx,970x250,10346.96656,1310454,1143870,1914,3503,720,2783
USD,ttd family parent sx,970x90,4.807042,262,226,0,0,0,0
USD,ttd health wellness sx,300x100,0.082828,8,0,0,0,0,0
USD,Android Movers and Shakers,300x600,186.728233,3934,3647,179,44,42,2
USD,DO NOT USE Spanish Language Sites,250x250,1.551679,153,143,0,0,0,0
USD,DO NOT USE Tier 1* (CHANNEL),336x280,31.648695,2369,2069,0,21,0,21
USD,Pac Fox Atlanta EXCLUSION List,300x600,22.443863,10726,9626,6,8,2,6
USD,allan- UOC  high click rate /  converter list ,300x600,0,0,0,0,1,0,1
USD,at black perf arts sx 7,300x600,0.610521,136,105,0,0,0,0
USD,mogo marks kpi achievers sx,250x250,0.539065,31,26,0,0,0,0
USD,mogo marks natl cat-aff-im sx 3,320x50,6264.622862,1043040,962651,2453,2252,705,1547
USD,mogo marks xsl_74205 sx ,250x250,24.215588,3697,3015,0,2,0,2
USD,mogo mba tier 1 sx,970x250,131.713022,3970,3438,10,56,1,55
USD,mogo music sx,320x51,0.8361,20,19,0,0,0,0
USD,pac canada sports sx,160x600,453.164209,71488,55973,36,64,3,61
USD,/All Apps/Google Play/Games/Casual,300x600,45.011312,2959,2685,108,22,19,3
USD,Android Top Selling Free Photography,300x600,82.239518,4505,3670,138,71,66,5
USD,BBB black sx,970x250,0.009344,2,2,0,0,0,0
USD,DO NOT USE Tier 3,160x600,13876.17428,3556050,3075499,1713,6943,434,6509
USD,mogo marks broadwayworld sx,160x600,1121.634853,61846,41762,43,331,21,310
USD,ttd gaming sx,200x200,2.047513,105,90,0,0,0,0
USD,/All Apps/Apple App Store/Games/Role Playing,300x600,0.337324,10,9,1,0,0,0
USD,/All Apps/Apple App Store/Productivity,300x50,1.05241,442,419,0,0,0,0
USD,/All Apps/Google Play/Personalization,300x600,0.910268,60,57,1,0,0,0
USD,Cal Performances Perf Arts 5 5 black sx,160x600,0.501803,19,13,0,0,0,0
USD,DO NOT USE Rubicon,468x60,0.002321,2,2,0,0,0,0
USD,DO NOT USE Tier 3 (2),300x600,881.134625,145886,116631,127,550,59,491
USD,Diablo DVC Shortlist (Advertiser Level),300x250,958.10178,74585,70086,33,8741,133,8608
USD,Western Black sx,320x50,468.247488,160925,152823,98,940,32,908
USD,mogo biz-fi sx,970x90,15.580121,752,660,1,2,0,2
USD,mogo financial services kpi sx,300x50,131.882175,27506,24676,12,401,14,387
USD,mogo marks branding drhbx gold sx,336x280,13.334753,1101,931,0,6,0,6
USD,mogo marks broadway sx,970x90,0.523822,32,28,0,0,0,0
USD,mogo marks xsl_800p sx,300x250,127172.4164,25652910,20210520,13671,51640,4139,47501
USD,ttd kids sx,468x60,0.092352,43,33,0,0,0,0
USD,/All Apps/Google Play,300x250,4161.438552,773330,689161,2647,833,666,167
USD,Belmont Sitelist v1,320x50,76.039061,32075,30058,13,26,3,23
USD,DO NOT USE Invite December Brand Safe List,468x60,1.407748,580,352,0,0,0,0
USD,DO NOT USE OAM FR,160x600,4.751875,1298,1188,0,0,0,0
USD,mogo black rt sx,300x250,11.519427,1738,1470,2,9,0,9
USD,mogo marks lal (purchase) silver sx,300x600,31606.2297,2887293,2503425,2977,15326,1202,14124
USD,mogo marks lal branding (All) platinum sx,300x600,5532.717072,395376,339915,579,2220,155,2065
USD,mogo universal rt+ob black sx,728x90,5.171186,642,429,5,3,1,2
USD,sfoc kpi sx (acquisition 2019),300x250,357.885528,46958,42520,30,658,39,619
USD,mogo financial services kpi sx,120x600,0.126456,45,39,0,0,0,0
USD,mogo marks bwwpb sx,970x90,0.442692,15,12,0,0,0,0
USD,mogo marks lal (purchase) gold sx,320x100,47.177593,8696,8066,14,34,4,30
USD,mogo marks natl cat-aff-im sx 3,728x90,7165.225499,604292,488573,276,2578,105,2473
USD,/All Apps/Google Play/Productivity,300x600,36.666029,986,899,25,2,2,0
USD,DO NOT USE Tier 3,200x200,1.74975,217,174,0,1,0,1
USD,mogo marks bay area sx,300x600,884.930499,228824,117930,75,295,32,263
USD,mogo marks branding tier 2 sx xls37852,300x600,27441.67922,2695173,2258416,2979,11959,1115,10844
USD,mogo marks visual arts sx,300x600,10.062488,7247,3461,22,1,1,0
USD,/All Apps,970x90,0.072127,46,46,0,0,0,0
USD,/All Apps/Apple App Store/Newsstand,320x50,0.00759,2,2,0,0,0,0
USD,DO NOT USE Invite December Brand Safe List,320x100,149.9831,24565,22866,50,71,17,54
USD,Fan Extender IMG/Sidearm Blacklist,728x90,7.8436,1788,1633,2,1,0,1
USD,Performing Arts Fort Worth Perf Arts 5 black sx,300x600,1.65514,311,289,0,0,0,0
USD,mogo black sx,320x50,2367.802901,659346,592208,792,526,60,466
USD,mogo canada t1 sx,970x250,5219.905179,646273,573899,964,1694,309,1385
USD,mogo centro sx US (2014),728x90,7390.889629,1808288,1431213,880,3257,361,2896
USD,mogo cult soph sx,970x250,5205.921775,521043,453225,798,1640,319,1321
USD,mogo marks dallas sx,320x50,1282.799325,309225,286691,342,668,173,495
USD,mogo marks hq100p sx,300x600,16599.58919,1884325,1556042,1786,6016,651,5365
USD,mogo marks phoenix sx,970x250,1.746362,88,73,0,0,0,0
USD,mogo perf arts sx,320x51,0.8361,20,19,0,0,0,0
USD,ttd kids sx,320x100,63.077924,8694,8262,13,9,5,4
USD,Android Top Selling Free Business,300x600,2.167885,112,107,0,0,0,0
USD,Channel of Top Global Sites for Nielsen Display Ads - DO NOT EDIT,300x100,4.027096,807,712,1,0,0,0
USD,DCPA video local sx,300x250,37.548346,4586,3173,7,10,1,9
USD,Provident High CTR List ,320x50,920.140486,90267,86784,123,3,0,3
USD,mogo CBS Interactive sx,336x280,0.825272,44,35,0,0,0,0
USD,mogo marks native (sharethrough) unique can sx,250x250,10.95821,1549,1340,2,1,0,1
USD,mogo marks natl elite cat-aff-im sx,336x280,1.598944,60,46,0,1,0,1
USD,mogo marks xsl66781 sx,300x600,10700.91534,1608576,1363600,1027,4604,431,4173
USD,pac canada sports sx,200x200,0.026112,2,0,0,0,0,0
USD,/All Apps/Apple App Store/Education,160x600,0.019262,1,1,0,0,0,0
USD,mogo marks chicago sx,300x50,2.947512,592,555,0,6,0,6
USD,mogo marks classical music sx,300x50,0.425535,37,36,0,0,0,0
USD,mogo marks lal (purchase) platinum sx,300x250,10401.63652,858365,616119,791,4671,315,4356
USD,mogo marks pav kpi hx,320x50,10504.0314,2973893,2569639,3326,3882,893,2989
USD,mogo marks t1 brand kpi sx x8t,728x90,10039.37332,1083027,745037,436,2922,172,2750
USD,sfoc expedia sx,160x600,0.061662,2,2,0,0,0,0
USD,/All Apps/Apple App Store/Reference,728x90,35.506099,16944,16285,38,1,1,0
USD,DO NOT USE Tier 3* (CHANNEL),600x250,0.000272,1,0,0,0,0,0
USD,mogo marks branding tier 3 sx xls37852,120x600,1.891461,187,149,0,0,0,0
USD,mogo marks broadwayworld sx,200x200,0.014553,1,0,0,0,0,0
USD,mogo marks wedding sx,320x50,37.034324,4708,4459,4,9,0,9
USD,sfoc pslx 2018 sx (Jun_2018),160x600,477.994152,161233,149401,105,519,63,456
USD,/All Apps/Apple App Store/Travel,300x250,160.55974,63875,52383,96,1,1,0
USD,Android Top Selling Free Entertainment,300x250,57.418927,4508,3826,52,14,12,2
USD,Channel of Top non-US Sites for Nielsen Display Ads - DO NOT EDIT,300x600,33959.95124,4379914,3738903,3555,17068,1265,15803
USD,mogo marks branding drhbx gold sx,728x90,14034.67062,1500001,1199228,879,5682,335,5347
USD,mogo marks seattle sx,320x50,118.964924,59185,53506,20,38,3,35
USD,mogo marks sports sx,970x250,519.318728,24902,21593,73,144,9,135
USD,/All Apps/Apple App Store/Games/Sports,320x50,3.841214,5178,5117,9,0,0,0
USD,Channel of Top US Sites for Nielsen Display Ads - DO NOT EDIT,970x66,1.214435,549,161,0,0,0,0
USD,Mogo DBM basic video sx,240x400,0.02323,5,1,0,0,0,0
USD,mogo lydia peacecenter test,300x600,12064.22476,1568344,1308214,1288,4238,504,3734
USD,mogo marks rt+ob lt_lq black sx  ,300x250,0.523371,61,47,0,0,0,0
USD,/All Apps/Google Play/Games/Simulation,320x50,3.279582,3276,3223,13,0,0,0
USD,mogo marks bay area sx,970x66,0.000028,1,0,0,0,0,0
USD,mogo marks branding drhbx platinum sx,300x250,9620.618446,1264105,991749,1379,3274,414,2860
USD,mogo marks nyc sx,336x280,0.815104,46,33,0,1,0,1
USD,mogo marks philadelphia sx,160x600,0.259649,36,22,0,0,0,0
USD,mogo marks video branding extended reach tail aggregate sx,300x250,103712.8064,22929865,18692402,11441,37996,3341,34655
USD,mogo marks xsl66781 sx,970x66,0.049335,9,4,0,0,0,0
USD,pac esports sx,300x50,100.923353,24411,21637,9,369,15,354
USD,/All Apps/Google Play/Games/Puzzle,300x250,25.611828,2911,2466,16,2,1,1
USD,Android Top Selling Free Tools,300x600,70.727027,5294,4285,69,20,19,1
USD,DO NOT USE Tier 1* (CHANNEL),728x90,37060.82296,6658059,5147098,4977,15804,1189,14615
USD,Duxiana Broadcast blacklist,970x250,0.296191,63,51,0,0,0,0
USD,PAC Singapore Rugby sx,160x600,0.0115,1,1,0,0,0,0
USD,iab aff-im black sx,160x600,0.016823,1,1,0,0,0,0
USD,mogo marks kpi mdx sx xls9297,468x60,0.004844,2,0,0,0,0,0
USD,mogo universal rt+ob black sx,300x50,0.004906,1,1,0,0,0,0
USD,/All Apps/Google Play/Games/Strategy,160x600,0.025587,5,5,0,0,0,0
USD,BBB perf arts 5 black sx,970x250,0.274879,25,24,0,0,0,0
USD,Channel of Top Global Sites for Nielsen Video Ads - DO NOT EDIT,320x51,0.837271,21,20,0,0,0,0
USD,mogo marks native standard reach (no) tail aggregate sx,970x66,0.715728,219,134,0,0,0,0
USD,mogo marks outbound kpi sx x1a,300x50,6.651033,578,531,0,17,0,17
USD,/All Apps/Apple App Store/Games/Role Playing,300x250,0.016934,1,1,1,0,0,0
USD,Android Top Selling Free Music and Audio,320x50,304.195728,335401,324600,407,42,18,24
USD,Mercury Theater Chicago sx,320x50,65.074696,42265,34378,17,25,9,16
USD,mogo marks agg sx xsl37589,900x90,0.001275,1,1,0,0,0,0
USD,mogo marks lal (purchase) silver sx,300x250,86537.37421,14372515,11661062,8919,39990,2864,37126
USD,mogo marks lal branding (All) platinum sx,300x250,11874.66281,1147192,823076,906,5452,351,5101
USD,mogo marks ttd obx kitchen premium sink sx,200x200,1.528762,230,158,0,2,0,2
USD,sfoc hqcat black hx,728x90,2.683738,218,189,1,0,0,0
USD,/All Apps/Google Play/Games/Board,300x600,8.905666,624,548,8,0,0,0
USD,African American Interests sx,320x50,1.594685,292,273,0,0,0,0
USD,Android Movers and Shakers,300x250,69.101241,11213,8351,113,29,25,4
USD,Android Top Selling Free Music and Audio,728x90,2.82736,1669,1619,3,0,0,0
USD,Brandcast Blacklist ,120x600,0.06703,19,19,0,0,0,0
USD,Cal Perf KPI sx ,160x600,53.970167,9499,7634,4,3,0,3
USD,at black perf arts sx 7,300x250,0.032637,5,2,0,0,0,0
USD,mogo marks pav kpi sx,300x100,0.153683,27,20,0,0,0,0
USD,mogo marks video sx xsl44760 class c,120x600,1.113032,409,332,0,0,0,0
USD,ttd auto sx,160x600,27.063056,3165,2517,2,12,0,12
USD,ttd shopping sx,160x600,359.645832,38661,24341,24,150,3,147
USD,/All Apps,250x250,0.012546,2,2,0,0,0,0
USD,DO NOT USE Microsoft Bin (001),300x600,71.859782,54266,44541,17,15,0,15
USD,allan- UOC  high click rate /  converter list ,300x250,0,0,0,0,4,0,4
USD,co top 41 converting,300x600,20.450485,2381,1845,5,9,0,9
USD,education master sx,970x66,0.052649,12,6,0,0,0,0
USD,fgu test public channel,320x50,240.824565,49827,42696,22,55,3,52
USD,mogo marks xsl_74205 (2p dims) sx ,970x250,5424.790359,726300,642095,994,2056,434,1622
USD,ttd sports sx,970x90,94.073103,6051,5080,1,3,0,3
USD,/All Apps/Google Play/Games,320x50,831.522862,530157,513465,1570,274,220,54
USD,DO NOT USE OAM UK,970x250,180.585342,28404,24407,43,57,12,45
USD,DO NOT USE Tier 3 (2),300x250,2628.628524,492209,372292,296,1990,94,1896
USD,DO NOT USE Tier 3* (CHANNEL) (2),240x400,0.051771,3,2,0,0,0,0
USD,LSSU url v1,160x600,16.644949,1987,1884,0,45,0,45
USD,Pac Private Events/Wedding sx,250x250,0.176872,13,9,0,1,0,1
USD,mogo cult soph sx,468x60,0.242488,88,36,0,0,0,0
USD,mogo marks native high reach tail aggregate sx,300x50,2115.188417,361658,343210,199,5634,152,5482
USD,mogo marks outbound kpi sx x1a,970x250,4257.796636,281671,230123,551,1263,270,993
USD,mogo marks perf arts gold sx,300x50,0.84575,59,53,0,3,0,3
USD,mogo marks video branding max reach tail aggregate sx,300x250,142922.0267,30808841,24418305,15700,53986,4559,49427
USD,/All Apps/Apple App Store/News,250x250,0.007318,1,1,0,0,0,0
USD,/All Apps/Google Play/Personalization,300x250,0.327651,85,76,0,0,0,0
USD,Android Top Selling Free Photography,300x250,52.460995,3980,3252,71,27,25,2
USD,Western Black sx,728x90,155.41838,46267,44009,19,427,4,423
USD,mogo canada t1 sx,468x60,0.682045,281,218,0,0,0,0
USD,mogo marks xsl_74205 (4p dims) sx ,320x50,10127.60053,2992430,2643304,1962,4452,616,3836
USD,ttd male sx,970x90,35.103167,2091,1820,0,3,0,3
USD,ttd tech sx,970x66,0.025979,12,3,0,0,0,0
USD,/All Apps/Google Play/Communication,728x90,0.87907,541,476,1,0,0,0
USD,/All Apps/Google Play/News & Magazines,320x50,798.761628,370691,350264,499,67,18,49
USD,/All Apps/Google Play/Weather,300x600,8.819512,130,121,2,7,3,4
USD,Android Top Selling Free Health and Fitness,300x50,0.596859,103,89,0,0,0,0
USD,DO NOT USE Invite December Brand Safe List,300x250,55167.13143,10946492,8353843,6329,22506,1971,20535
USD,Stratford KPI sx,970x250,9.792748,1217,1086,1,29,0,29
USD,mogo marks elite kpi achievers sx,120x600,0.001604,1,0,0,0,0,0
USD,mogo marks native (sharethrough) unique us sx,300x250,18888.49597,3629334,2872427,1963,6384,509,5875
USD,mogo marks natl cat-aff-im sx,970x250,5650.276924,522789,441731,864,2082,450,1632
USD,pac canada sports sx,300x600,1749.066542,188167,162350,235,617,75,542
USD,sfjazz travel sx,970x250,25.251858,858,802,4,5,0,5
USD,ttd kids sx,300x250,742.627519,234330,177400,158,568,57,511
USD,ttd travel sx,320x50,8549.616449,684833,633407,3377,4127,2949,1178
USD,/All Apps/Apple App Store/Productivity,320x100,0.016215,6,6,0,0,0,0
USD,5a kpi sx,320x100,8.765242,445,292,0,4,0,4
USD,BR Native sx,320x50,455.871299,142409,137081,83,149,34,115
USD,Brandcast Blacklist ,728x90,6033.731281,1013561,839553,463,6523,218,6305
USD,DO NOT USE Mobile - MoPub - Arts & Entertainment/Entertainment Industry/Recording Industry,320x50,20.312376,42534,42388,59,0,0,0
USD,fgu test public channel,336x280,0.012132,1,1,0,0,0,0
USD,kid safe sx,970x66,0.186213,31,13,0,0,0,0
USD,mogo jacks education sx,300x600,0.062011,19,11,0,0,0,0
USD,mogo marks disney sx,320x100,2.637292,218,199,0,0,0,0
USD,mogo marks video sx xsl44760 class c,970x250,7568.072132,1017023,891817,1416,2660,504,2156
USD,finn dallas native sx,300x50,3.123351,505,476,0,5,0,5
USD,magic theatre native black list,300x250,0.006354,1,1,0,0,0,0
USD,mogo marks broadwayworld sx,300x600,110.054894,9099,3346,2,32,2,30
USD,mogo marks elite kpi achievers sx,300x50,7.649069,521,495,2,22,2,20
USD,mogo marks native (sharethrough) unique can sx,200x200,0.647713,44,38,0,0,0,0
USD,/All Apps/Apple App Store/Business,300x250,114.08278,45215,39081,62,4,1,3
USD,/All Apps/Apple App Store/Navigation,728x90,8.340854,1582,1562,8,0,0,0
USD,/All Apps/Google Play/Games,336x280,0.291792,85,57,1,2,2,0
USD,Android Top Selling Free Travel and Local,300x600,0.754544,34,30,1,0,0,0
USD,Cal Performances Perf Arts 5 5 black sx,300x600,5.921428,280,247,0,0,0,0
USD,DO NOT USE Rubicon,300x250,2401.092901,338864,200228,200,915,94,821
USD,GG KPI sx,320x50,329.795995,13968,13207,11,9,1,8
USD,dbm video sx,Unknown,5452.056295,162953,155927,839,110,0,110
USD,dbm video sx,160x600,4124.564792,1012205,957314,320,1068,104,964
USD,mogo marks agg sx xsl37589,970x66,1.276249,592,164,0,0,0,0
USD,mogo marks branding elite tier sx xls37852,970x250,3868.631811,262819,215497,480,1168,259,909
USD,mogo marks native high reach tail aggregate sx,970x250,9291.714462,1218810,1065819,1757,3535,624,2911
USD,mogo marks native medium reach tail aggregate sx,970x66,0.937084,294,153,0,0,0,0
USD,mogo marks pav kpi sx,300x250,3300.137377,208899,143205,312,1361,147,1214
USD,mogo marks xsl_74205 (4p dims) sx ,336x280,10.926868,863,784,0,2,0,2
USD,ttd real estate sx,300x50,2.930912,219,213,1,5,1,4
USD,/All Apps/Google Play/Games/Music,300x50,0.092693,35,35,0,0,0,0
USD,DO NOT USE Tier 3* (CHANNEL) (2),160x600,908.832754,252184,221205,220,584,54,530
USD,DO NOT USE fgu test public channel,160x600,139.19825,21393,10431,9,52,2,50
USD,dso kpi audx sx,320x50,82.604865,11952,11311,5,247,0,247
USD,mogo CBS Interactive sx,300x50,56.847683,9500,9011,15,94,5,89
USD,mogo marks branding comp rate silver video sx,970x66,0.088683,56,9,0,0,0,0
USD,mogo marks branding drhbx silver sx,970x66,0.870361,257,140,0,0,0,0
USD,mogo marks jazz & blues sx,320x100,0.333481,334,277,1,0,0,0
USD,mogo marks natl cat-aff-im sx 2,970x66,0.049335,9,4,0,0,0,0
USD,mogo marks pav kpi sx 3,320x50,2078.007261,312118,283745,455,1042,153,889
USD,mogo marks san francisco sx,970x250,36.129996,5945,2632,4,8,2,6
USD,/All Apps/Google Play/Weather,970x250,0.039934,1,1,0,0,0,0
USD,mogo canada t1 sx,728x90,12009.29126,1471322,1149234,1505,4915,235,4680
USD,mogo cult soph sx,728x90,11555.16461,1940971,1543324,863,4067,397,3670
USD,mogo marks email sx,300x250,11319.21151,2964353,2466838,648,2536,176,2360
USD,mogo marks pav kpi sx,320x100,8.765242,445,292,0,4,0,4
USD,mogo marks phoenix sx,728x90,376.934713,206087,44282,91,241,51,190
USD,mogo marks t1 brand sx trim,200x200,0.22285,17,15,0,1,0,1
USD,mogo marks video branding max reach tail aggregate sx,970x90,306.939085,23545,20346,29,22,0,22
USD,ttd female sx,160x600,325.153225,40634,27062,14,155,3,152
USD,/All Apps/Apple App Store/Games/Board,336x280,0.003105,1,1,0,0,0,0
USD,/All Apps/Apple App Store/Games/Simulation,300x50,0.068606,11,10,0,0,0,0
USD,mogo jacks education sx,970x250,0.028143,35,26,0,0,0,0
USD,mogo marks native (sharethrough) unique us sx,320x100,35.725312,3820,3454,7,20,2,18
USD,mogo marks xsl_ks20780 sx,320x50,103026.8754,29093308,26761432,29928,41050,10536,30514
USD,/All Apps/Apple App Store/Games,300x50,23.211783,2489,2411,11,0,0,0
USD,/All Apps/Google Play/Games/Simulation,160x600,0.015956,4,3,0,0,0,0
USD,PAC Singapore sx,300x250,306.681728,13653,10366,14,56,1,55
USD,mogo marks perf arts sx 7,320x50,1912.273708,184057,167579,200,1154,96,1058
USD,mogo marks ttd obx kitchen premium sink sx,320x51,0.8361,20,19,0,0,0,0
USD,mogo marks xsl_800p sx,970x90,264.800324,20681,17670,15,23,0,23
USD,ttd news sx,336x280,12.203459,1089,1000,0,4,0,4
USD,ttd spanish sx,300x600,67.976235,11176,8870,10,33,1,32
USD,ttd weather sx,250x250,0.18521,11,9,0,0,0,0
USD,/All Apps/Apple App Store/Games/Educational,300x250,0.16629,19,18,0,0,0,0
USD,Android Top Selling Free Books and Reference,320x50,65.36524,30875,28717,84,44,34,10
USD,mogo marks broadwayworld sx,970x250,149.630765,5237,3455,17,93,58,35
USD,mogo marks pav kpi sx 2,250x250,0.689675,89,71,0,0,0,0
USD,mogo marks seattle sx,160x600,4.060391,1077,812,0,2,0,2
USD,/All Apps/Google Play/Shopping,320x50,101.363151,32257,30300,21,3,2,1
USD,DO NOT USE Mobile - MoPub - People & Society,300x50,1.582702,233,201,0,0,0,0
USD,mogo marks lal branding (All) silver sx,320x51,0.8361,20,19,0,0,0,0
USD,pac canada sports sx,970x250,748.452351,46284,38604,101,232,26,206
USD,ttd health sx,300x50,253.448779,26378,25172,13,986,25,961
USD,/All Apps/Google Play/Education,320x50,26.639155,18929,18287,46,7,6,1
USD,Android Top Selling Free News and Magazines,250x250,0.005227,1,1,0,0,0,0
USD,mogo marks lal branding (All) silver sx,200x200,1.155455,149,90,0,1,0,1
USD,mogo marks video branding max reach tail aggregate sx,320x51,0.837271,21,20,0,0,0,0
USD,ttd travel sx,120x600,0.408055,26,19,0,0,0,0
USD,ttd weather sx,320x50,6883.552271,313942,290016,3178,3422,2897,525
USD,/All Apps/Google Play/Finance,320x50,24.546748,7437,6953,23,1,1,0
USD,African American Interests sx,970x250,0.080155,2,2,0,0,0,0
USD,Channel of Top Global Sites for Nielsen Display Ads - DO NOT EDIT,970x90,317.30437,24777,21333,20,29,0,29
USD,mogo marks coupon sx,200x200,0.209768,18,15,0,0,0,0
USD,mogo marks high intenders sx,250x250,0.403048,37,30,0,2,0,2
USD,mogo marks nyt sx,336x280,0.071937,16,11,0,0,0,0
USD,mogo marks pav kpi sx 2,320x50,6936.153005,1479562,1392567,1662,2865,545,2320
USD,mogo marks xsl_800p sx,320x51,0.837271,21,20,0,0,0,0
USD,mogo perf arts sx,200x200,0.070799,6,5,0,0,0,0
USD,ttd news sx,300x600,13646.23084,1557402,1254239,1641,4406,579,3827
USD,/All Apps/Google Play/Games,970x250,5.246816,424,369,5,1,1,0
USD,Android Top Selling Free Game,300x250,147.097643,8191,7122,86,28,28,0
USD,fgu test public channel,970x250,693.468239,46601,40440,108,153,23,130
USD,mogo marks lal (purchase) gold sx,970x66,0.035429,6,4,0,0,0,0
USD,mogo marks xsl_74205 (4p dims) sx ,970x250,4783.342772,408230,341327,646,1769,346,1423
USD,/All Apps/Apple App Store/Navigation,300x50,9.065769,397,379,3,0,0,0
USD,Channel of Top non-US Sites for Nielsen Display Ads - DO NOT EDIT,728x90,43712.59459,8914237,7416826,4371,20363,1104,19259
USD,Duxiana - Longtail Blacklist,160x600,33.051333,34337,30811,21,0,0,0
USD,Mercury Theater Chicago sx,728x90,216.942981,100823,83251,82,81,74,7
USD,mogo lydia peacecenter test,728x90,14402.52439,2264473,1770008,1663,4536,375,4161
USD,mogo marks ballet sx,160x600,0.751666,72,43,0,1,0,1
USD,mogo universal rt+ob black sx,320x100,0.008682,1,0,0,0,0,0
USD,ttd education sx,336x280,2.84862,634,520,0,0,0,0
USD,/All Apps/Google Play/News & Magazines,300x50,12.680189,3510,3391,5,0,0,0
USD,Android Top Selling Free Tools,728x90,0.476781,163,145,0,0,0,0
USD,DO NOT USE Tier 3,300x100,0.727688,134,122,0,0,0,0
USD,mogo marks kpi mdx sx xls9297,300x250,21354.95895,2637526,2144639,2362,7532,817,6715
USD,mogo marks natl cat-aff-im sx 3,320x100,9.592061,650,478,0,4,0,4
USD,mogo marks video sx xsl44760 class a,160x600,1639.633638,653938,648015,138,136,55,81
USD,DO NOT USE Mobile - MoPub - Computers & Electronics/Software/Multimedia Software/Audio & Music Software,300x50,0.01878,12,12,0,0,0,0
USD,mogo cult soph sx,300x50,148.03829,23646,22579,18,354,19,335
USD,mogo marks branding elite tier sx xls37852,336x280,0.894454,48,35,0,1,0,1
USD,mogo marks kpi mdx sx xls9297,970x250,4801.145139,359537,296268,614,1597,327,1270
USD,mogo marks lal (purchase) silver sx,320x100,201.457895,39723,36940,60,112,22,90
USD,mogo marks native high reach tail aggregate sx,336x280,73.86412,8498,7308,3,19,0,19
USD,mogo marks natl cat-aff-im sx 2,970x90,29.724707,2353,2020,2,4,0,4
USD,mogo marks ttd obx kitchen premium sink sx,250x250,70.85418,8777,7240,1,12,0,12
USD,mogo marks video sx xsl44760 class c,336x280,27.321794,6248,5480,6,7,0,7
USD,ttd real estate sx,320x50,148.494819,28821,27616,26,63,8,55
USD,/All Apps/Google Play/Games/Music,728x90,0.256971,147,142,1,0,0,0
USD,Android Top Selling Free Game,970x250,0.466653,30,26,0,0,0,0
USD,DO NOT USE,160x600,0.086342,2,2,1,0,0,0
USD,DO NOT USE Microsoft Bin (001),970x250,18.179327,222449,213554,166,15,2,13
USD,DO_NOT_USE Mobile - MoPub - Games,160x600,0.007188,1,1,0,0,0,0
USD,co top 41 converting,970x250,7.403136,317,253,1,0,0,0
USD,mogo cult soph sx,120x600,0.118982,32,27,0,0,0,0
USD,mogo marks agg sx xsl37589,970x90,416.485076,31320,27164,32,39,1,38
USD,mogo marks xsl_ks0001 sx,300x250,130279.6751,26637639,20951416,13723,47546,4154,43392
USD,ttd food sx,300x250,4642.620282,568515,465145,303,2794,125,2669
USD,/All Apps/Apple App Store/Games/Arcade,300x250,0.651237,112,74,1,0,0,0
USD,Android Top Selling Free Health and Fitness,320x50,36.207146,12609,8889,8,15,0,15
USD,DO NOT USE Tier 1* (CHANNEL),240x400,0.030607,3,2,0,0,0,0
USD,mogo CBS Interactive sx,320x50,1532.733543,316485,288642,528,435,109,326
USD,mogo marks ballet sx,970x90,0.031107,2,1,0,0,0,0
USD,mogo marks natl elite cat-aff-im sx,320x50,1833.189324,348020,306490,279,1138,157,981
USD,mogo marks t1 brand kpi sx x8t,300x50,44.548204,5163,4944,7,127,4,123
USD,mogo t1 brand sx,250x250,18.470749,2174,1728,1,4,0,4
USD,pac motorsports sx,300x600,428.110164,24006,20945,25,110,3,107
USD,/All Apps/Apple App Store/Finance,320x50,41.717353,6751,6504,18,0,0,0
USD,DO NOT USE All Google Anonymous,160x600,0.012195,1,1,0,0,0,0
USD,mogo marks branding comp rate platinum video sx,300x600,10627.79087,1225837,992015,1311,3217,450,2767
USD,mogo marks ticketing sx,300x250,586.826249,38928,31551,14,248,2,246
USD,mogo marks wsj sx x4v,320x50,0.103262,5,2,0,0,0,0
USD,ttd spanish sx,300x100,0.81117,219,198,1,0,0,0
USD,ttd travel sx,200x200,0.031154,6,3,0,1,0,1
USD,DO NOT USE Android Top Selling Free Media and Video,300x600,1.059492,216,192,2,1,1,0
USD,finn dallas native sx,728x90,459.942243,176715,141705,76,179,28,151
USD,mogo marks lal branding (All) platinum sx,320x100,18.960111,1994,1652,4,14,0,14
USD,mogo marks video sx xsl44760 class a,970x90,4.283056,102,81,0,0,0,0
USD,sfoc 2018 marks stratford premium sx,160x600,443.553276,150463,139623,102,418,60,358
USD,t1 brand black sx,728x90,2.796002,97,91,0,0,0,0
USD,ttd family parent sx,160x600,469.010107,139734,127142,47,179,13,166
USD,/All Apps/Google Play/Games,300x50,45.75306,6842,6637,21,0,0,0
USD,/All Apps/Google Play/Games/Simulation,970x250,0.001955,1,1,0,0,0,0
USD,5a kpi sx,300x250,175.265885,6976,4525,8,141,5,136
USD,Stratford KPI revised,160x600,8.374604,793,697,0,38,0,38
USD,mogo marks disney sx,300x250,112.18683,16000,10320,10,32,4,28
USD,mogo marks nyt sx,320x50,0.281924,127,95,0,0,0,0
USD,mogo marks perf arts silver sx,320x100,9.356745,516,338,0,4,0,4
USD,mogo marks xsl_74205 (4p dims) sx ,300x50,123.010377,29358,26408,10,375,17,358
USD,sfoc pslx 2018 sx (Jun_2018),728x90,1668.928438,380857,352750,208,2925,148,2777
USD,/All Apps/Apple App Store/Games/Sports,970x250,0.081477,5,4,0,0,0,0
USD,/All Apps/Apple App Store/Medical,320x50,16.779234,24177,23739,60,0,0,0
USD,APACTix Sitelist sx,300x600,68.137315,2123,1679,3,12,1,11
USD,Channel of Top non-US Sites for Nielsen Display Ads - DO NOT EDIT,120x600,8.144822,1792,1499,1,0,0,0
USD,mogo lydia peacecenter test,120x600,0.309209,78,71,0,0,0,0
USD,mogo marks branding increased reach sx,160x600,46371.28661,12355549,10931691,5301,23250,1679,21571
USD,mogo marks seattle sx,970x250,15.574855,2863,2403,1,0,0,0
USD,ttd news sx,468x60,0.059178,20,9,0,0,0,0
USD,mogo marks branding drhbx gold sx,320x100,93.655943,21087,19316,20,85,5,80
USD,mogo marks branding drhbx silver sx,320x51,0.8361,20,19,0,0,0,0
USD,mogo marks jazz & blues sx,300x250,138.781358,27842,21383,6,70,3,67
USD,Performing Arts Fort Worth sx,300x250,24.874468,5149,4646,3,19,0,19
USD,ttd education sx,320x50,3555.426612,1617733,1516296,1303,1778,322,1456
USD,ttd health wellness sx,160x600,433.450321,37768,29303,50,304,7,297
USD,Android Top Selling Free Music and Audio,300x50,12.320617,3172,2977,2,1,0,1
USD,Channel of Top Global Sites for Nielsen Display Ads - DO NOT EDIT,320x100,333.708378,54509,50340,95,178,33,145
USD,mogo marks branding max reach sx,160x600,48535.98121,12787862,11285679,5604,24942,1766,23176
USD,mogo marks lal (purchase) gold sx,160x600,7560.280606,850612,722878,609,3871,195,3676
USD,mogo marks native (sharethrough) unique can sx,300x600,4596.631954,583573,482689,603,1982,183,1799
USD,mogo marks natl elite cat-aff-im sx,468x60,0.004844,2,0,0,0,0,0
USD,mogo marks xsl_74205 (4p dims) sx ,120x600,0.12627,15,14,0,0,0,0
USD,sfjazz travel sx,300x600,67.580523,4002,3737,5,20,4,16
USD,sfoc cix sx,300x250,28.983687,1557,1384,0,115,0,115
USD,ttd spanish sx,970x90,0.508348,129,108,0,0,0,0
USD,/All Apps/Apple App Store/Games/Board,970x250,4.395583,357,336,6,0,0,0
USD,mogo marks shakespeare sx,160x600,14.683539,1655,1129,0,0,0,0
USD,/All Apps/Apple App Store/Weather,300x600,0.207489,9,9,0,0,0,0
USD,Duxiana- Bad Site List(Allan) ,160x600,17.965412,13312,11959,7,5,0,5
USD,Lynn Grad,728x90,42.840017,6205,5775,1,29,1,28
USD,mogo marks xsl_ks20780 sx,300x50,2787.102469,523880,494573,249,7784,195,7589
USD,ttd health wellness sx,970x250,145.483947,10758,9875,19,34,17,17
USD,Duxiana - KPI sx,728x90,192.628927,87991,76758,50,6,0,6
USD,mogo marks branding max reach sx,970x250,11940.09304,1459918,1272751,2168,4172,777,3395
USD,mogo marks branding tier 1 sx xls37852,240x400,0.054511,6,5,0,0,0,0
USD,mogo marks native high reach tail aggregate sx,970x90,266.166989,21694,18705,21,25,1,24
USD,mogo marks perf arts branding high reach sx,320x50,3310.951413,561612,501132,461,1684,167,1517
USD,mogo marks toronto sx,320x50,222.496779,103727,89229,54,234,40,194
USD,mogo marks travel sx,300x250,1052.253155,47274,37256,31,413,11,402
USD,ttd beauty sx,468x60,0.004927,2,1,0,0,0,0
USD,ttd tech sx,200x200,0.275313,98,49,0,0,0,0
USD,/All Apps/Google Play/Shopping,300x50,0.066664,40,35,0,0,0,0
USD,5a kpi sx,970x90,0.442692,15,12,0,0,0,0
USD,Android Top Selling Free Books and Reference,300x50,2.883316,422,401,0,8,4,4
USD,DO NOT USE Tier 2* (CHANNEL),728x90,8434.820957,1419340,1190483,871,8443,336,8107
USD,Mogo DBM premium video sx,250x250,20.113673,2543,2076,1,3,0,3
USD,Stratford KPI revised,970x250,23.57928,3266,2779,9,57,9,48
USD,education master sx,200x200,0.150526,14,14,0,0,0,0
USD,DO NOT USE Invite US Expandable Enabled Sites,120x600,0.038421,10,5,0,0,0,0
USD,Diablo Blacklist ,728x90,129.397387,12648,11912,5,782,8,774
USD,RCU Blacklist Sites (CPA),300x250,10.809533,1020,942,1,3,0,3
USD,mogo marks branding increased reach sx,200x200,5.171318,704,535,0,2,0,2
USD,mogo marks natl cat-aff-im sx,970x90,32.83313,2619,2214,2,4,0,4
USD,mogo marks xsl_ks0001 sx,240x400,0.020257,3,1,0,0,0,0
USD,sfoc stratford hqcat sx,160x600,5.837531,367,325,0,1,0,1
USD,/All Apps/Apple App Store/Health & Fitness,300x600,0.578392,13,8,1,0,0,0
USD,/All Apps/Google Play/Games/Card,160x600,1.917963,231,214,1,0,0,0
USD,/All Apps/Google Play/Games/Role Playing,728x90,0.615589,2177,2166,3,0,0,0
USD,Arvada local sx,320x50,14.02243,1517,1394,4,10,0,10
USD,mogo marks branding increased reach sx,300x100,3.547413,703,625,1,0,0,0
USD,mogo marks branding tier 1 sx xls37852,728x90,54433.92196,10257745,8096583,5110,27821,1531,26290
USD,mogo marks pav kpi sx,336x280,0.743167,30,22,0,1,0,1
USD,mogo marks perf arts sx 2,970x250,3872.278447,267971,219022,496,1170,258,912
USD,mogo marks ticketing sx,728x90,288.978577,27021,15333,9,139,5,134
USD,mogo mba tier 1 sx,160x600,8.700181,1290,1135,0,0,0,0
USD,mogo t1 brand sx,160x600,5325.576582,1788875,1601260,466,1718,146,1572
USD,ttd kids sx,336x280,3.564309,581,549,0,0,0,0
USD,Arizona Theatre Company - Site List,320x50,0.139622,11,6,0,0,0,0
USD,BBB black sx,160x600,0.099638,16,16,0,0,0,0
USD,Channel of Top US Sites for Nielsen Display Ads - DO NOT EDIT,120x600,11.179368,2898,2288,2,0,0,0
USD,Channel of Top non-US Sites for Nielsen Display Ads - DO NOT EDIT,320x51,0.001171,1,1,0,0,0,0
USD,DO NOT USE AppNexus - Collective Media,300x250,25475.54721,5427416,4099303,2997,9967,982,8985
USD,DO NOT USE Mobile - MoPub - People & Society,320x50,28.920038,8967,6889,19,1,1,0
USD,dbm native sx (adx),320x100,89.378236,10845,10292,17,18,13,5
USD,mogo marks bwwpb sx,300x250,2980.357805,172323,117844,268,1197,118,1079
USD,mogo marks lal (purchase) platinum sx,300x50,91.869517,7172,6806,6,373,2,371
USD,mogo marks sports sx,970x66,0.815601,235,133,0,0,0,0
USD,mogo marks t1 brand kpi sx x8t,200x200,0.014553,1,0,0,0,0,0
USD,sfjazz travel sx,300x250,114.507688,5824,5379,10,31,2,29
USD,sfoc pslx 2018 sx (Jun_2018_Archived),300x600,1378.673499,231345,215046,229,1796,201,1595
USD,ttd male sx,300x600,2115.20274,318265,265097,288,1057,107,950
USD,/All Apps/Apple App Store/Games/Puzzle,320x50,393.546776,288329,282352,624,30,14,16
USD,/All Apps/Apple App Store/Games/Simulation,320x50,5.907577,3315,3245,19,0,0,0
USD,Brandcast Blacklist ,250x250,15.227425,2728,2314,0,1,0,1
USD,mogo biz-fi sx,300x250,12594.71433,1681258,1361106,1778,3985,552,3433
USD,mogo centro sx US (2014),200x200,0.134175,8,8,0,0,0,0
USD,mogo marks broadway sx,300x250,3336.136522,209802,146854,310,1301,134,1167
USD,mogo marks lal (purchase) gold sx,300x100,0.203128,31,28,0,0,0,0
USD,mogo marks natl canada cat-aff-im sx,320x100,8.765242,445,292,0,4,0,4
USD,/All Apps/Apple App Store/Entertainment,320x50,1528.96437,1122026,1055817,1674,48,23,25
USD,/All Apps/Apple App Store/Games/Arcade,728x90,4.935602,4431,4382,11,1,1,0
USD,/All Apps/Apple App Store/Photo & Video,320x100,0.00023,1,1,0,0,0,0
USD,Android Top Selling Free Education,320x50,3.515427,2205,2113,19,0,0,0
USD,DO NOT USE OAM UK,160x600,300.680009,33907,29519,36,265,7,258
USD,education master sx,300x100,0.097726,20,17,0,0,0,0
USD,mogo marks xsl_ks0001 sx,728x90,59726.55142,11781686,9334912,5776,25688,1672,24016
USD,mogo sports sx,728x90,4523.654058,648278,519598,214,994,40,954
USD,ttd food sx,970x250,111.070553,9170,8074,18,79,12,67
USD,/All Apps/Google Play/Travel & Local,320x100,0.001092,1,1,0,0,0,0
USD,Android Top Selling Free Sports,320x100,0.005753,15,12,0,0,0,0
USD,mogo marks native standard reach (no) tail aggregate sx,120x600,2.915168,314,254,0,0,0,0
USD,mogo marks perf arts platinum sx,300x250,3811.512179,238040,168157,326,1545,147,1398
USD,mogo marks stratford (canada) sx,300x250,42.129778,5038,4408,0,92,0,92
USD,ttd health sx,320x50,5707.31025,929179,878844,792,3047,289,2758
USD,ttd sports sx,300x600,1185.435569,102768,86888,114,296,34,262
USD,ttd tech sx,300x100,0.005876,1,1,0,0,0,0
USD,Android Movers and Shakers,970x250,0.011793,5,5,0,0,0,0
USD,Pac Fox Atlanta EXCLUSION List,970x250,159.94273,6282,5462,20,32,5,27
USD,dso custom hx,300x250,34.710203,3619,3334,1,48,1,47
USD,mogo marks lal (purchase) platinum sx,468x60,0.004844,2,0,0,0,0,0
USD,/All Apps/Apple App Store/Newsstand/News & Politics,300x250,666.917548,235647,199645,260,12,5,7
USD,/All Apps/Google Play/Games/Casual,728x90,7.120123,5638,5421,16,2,2,0
USD,DO NOT USE Invite December Brand Safe List,120x600,1.786179,479,206,0,0,0,0
USD,Mogo DBM basic video sx,970x90,6.384462,418,361,0,0,0,0
USD,ttd female sx,300x250,7691.890759,1365588,1074621,658,3486,205,3281
USD,ttd kids sx,120x600,0.002151,2,0,0,0,0,0
USD,/All Apps/Apple App Store/Business,300x50,1.969365,290,270,1,0,0,0
USD,/All Apps/Apple App Store/Games/Role Playing,728x90,4.171321,1065,971,13,2,2,0
USD,/All Apps/Google Play,320x100,0.696166,317,282,0,0,0,0
USD,mogo marks lal branding (All) platinum sx,970x250,1260.975198,86499,70268,199,584,107,477
USD,mogo marks native standard reach (no) tail aggregate sx,468x60,2.007183,572,300,0,0,0,0
USD,mogo marks opera sx,160x600,21.917369,3642,2118,3,16,2,14
USD,ttd auto sx,970x90,3.193246,295,245,1,0,0,0
USD,ttd entertainment sx,300x250,26224.43789,5717067,4405675,3139,8740,1001,7739
USD,/All Apps/Apple App Store/Games/Trivia,300x250,0.975056,36,33,1,0,0,0
USD,/All Apps/Apple App Store/Reference,300x600,17.012712,487,281,23,0,0,0
USD,Android Top Selling Free Game,320x50,1616.602901,921238,888699,4072,709,618,91
USD,Android Top Selling Free Game,728x90,20.97736,11091,10606,90,24,23,1
USD,Android Top Selling Free Photography,970x250,0.052727,14,13,0,1,1,0
USD,Brandcast Blacklist ,200x200,0.049697,23,23,0,0,0,0
USD,DO NOT USE Invite US Expandable Enabled Sites,970x66,0.077846,17,9,0,0,0,0
USD,DO NOT USE Tier 3 (2),970x250,31.389014,3873,3161,7,18,1,17
USD,Mogo MMX tabx sx,300x250,0.003162,1,1,0,0,0,0
USD,mogo centro sx US (2014),300x600,3364.347616,511408,345187,388,891,139,752
USD,mogo marks xsl_800p sx,320x100,243.63987,46501,43082,77,145,27,118
USD,/All Apps/Google Play/Sports,300x600,1.686164,186,159,3,0,0,0
USD,DO NOT USE Invite December Brand Safe List,300x50,1046.835204,171046,161860,102,2941,82,2859
USD,DO NOT USE Tier 3* (CHANNEL),300x250,33958.12084,7223154,5285634,3650,13970,1048,12922
USD,mogo marks branding drhbx gold sx,240x400,0.049258,5,4,0,0,0,0
USD,mogo marks denver sx,970x250,11.485486,819,682,3,9,4,5
USD,mogo marks kpi mdx sx xls9297,320x50,9628.833755,2059122,1948702,1797,4432,583,3849
USD,mogo marks lal (purchase) silver sx,728x90,38967.31343,5811252,4640785,3470,23107,1019,22088
USD,mogo marks native (sharethrough) unique us sx,300x50,382.948633,89429,85016,39,940,28,912
USD,/All Apps/Apple App Store/Entertainment,160x600,24.997134,940,835,126,8,7,1
USD,Channel of Top US Sites for Nielsen Display Ads - DO NOT EDIT,240x400,0.37262,31,22,0,0,0,0
USD,DO NOT USE Invite US Expandable Enabled Sites,728x90,1983.483276,473824,391965,157,961,49,912
USD,ttd family parent sx,300x250,13360.39566,3473196,3002584,1085,2835,291,2544
USD,/All Apps/Apple App Store/Games/Casino,320x50,69.150997,52490,49865,111,3,3,0
USD,/All Apps/Apple App Store/News,300x50,7.447391,2507,2396,6,0,0,0
USD,bbb kpi sx (2019),728x90,228.871929,17638,16631,3,131,0,131
USD,mogo marks natl cat-aff-im sx 2,200x200,0.014553,1,0,0,0,0,0
USD,mogo marks ttd obx kitchen premium sink sx,Unknown,5452.056295,162953,155927,839,110,0,110
USD,mogo marks xsl_74205 sx ,300x50,175.821734,34249,31129,17,521,19,502
USD,mogo marks xsl_ks0001 sx,160x600,28671.60553,7416900,6560729,3199,11128,1019,10109
USD,mogo marks xsl_ks20780 sx,320x100,352.1884,58425,54009,95,180,31,149
USD,ttd news sx,970x90,44.430305,3067,2535,8,3,0,3
USD,/All Apps/Apple App Store/Games/Puzzle,160x600,16.044743,494,452,73,8,7,1
USD,DO NOT USE Mobile - MoPub - Online Communities,300x50,1.493171,711,694,4,0,0,0
USD,DO_NOT_USE Mobile - MoPub - Games,300x600,4.861813,197,169,3,0,0,0
USD,Mogo DBM select video sx,300x250,3125.846143,442222,374280,193,1695,40,1655
USD,Portland Center Stage KPI sx,300x250,11.445505,1906,1617,0,7,0,7
USD,mogo marks perf arts sx 7,320x100,9.3715,534,372,0,4,0,4
USD,mogo music sx,728x90,234.559264,46032,37891,28,80,5,75
USD,ttd sports sx,250x250,1.516078,194,153,0,1,0,1
USD,/All Apps/Apple App Store/Food & Drink,728x90,34.821424,12763,12242,15,3,2,1
USD,5a local sx seattle,320x50,6.650358,4455,4141,1,7,1,6
USD,Android Top Selling Free Books and Reference,320x100,0.026335,14,13,0,0,0,0
USD,DO NOT USE All Google Anonymous,300x250,0.119845,52,44,0,0,0,0
USD,mogo marks agg sx xsl37589,200x200,5.037433,592,426,0,2,0,2
USD,mogo marks lal (purchase) platinum sx,240x400,0.012357,1,1,0,0,0,0
USD,mogo marks lal branding (All) gold sx,300x250,41924.60515,5246731,3962875,4049,21891,1342,20549
USD,mogo marks pav kpi sx,970x66,0.004991,1,0,0,0,0,0
USD,mogo marks perf arts branding high reach sx,336x280,0.891718,38,30,0,2,0,2
USD,mogo marks sacramento sx,336x280,0.00575,1,1,0,0,0,0
USD,mogo marks ticketing sx,160x600,150.676855,13586,9411,4,41,3,38
USD,mogo marks xsl_74205 sx ,120x600,0.145074,17,15,0,0,0,0
USD,ttd male sx,250x250,1.481066,221,186,0,1,0,1
USD,Broadway sx,320x50,10.119316,294,266,0,4,0,4
USD,Duxiana - Longtail Blacklist,970x250,7.865874,1856,1472,5,0,0,0
USD,Pac Private Events/Wedding sx,300x50,0.124401,18,17,0,0,0,0
USD,Performing Arts Fort Worth black sx,970x250,0.227873,38,31,0,0,0,0
USD,mogo education sx,728x90,2121.058048,475636,401793,274,1644,93,1551
USD,mogo marks kpi mdx sx xls9297,970x90,29.361548,2003,1697,2,3,0,3
USD,mogo marks perf arts sx 5 epx1,970x250,295.647805,18915,11918,52,196,72,124
USD,mogo marks ttd obx kitchen premium sink sx,468x60,3.00428,1254,905,0,0,0,0
USD,mogo sports sx,160x600,506.828823,77722,61622,44,110,1,109
USD,Channel of Top non-US Sites for Nielsen Video Ads - DO NOT EDIT,300x100,1.383604,345,316,1,0,0,0
USD,DO NOT USE Tier 3,320x50,35841.51816,10352420,9586956,10357,13625,2872,10753
USD,DO NOT USE Tier 3* (CHANNEL),900x90,0.001275,1,1,0,0,0,0
USD,DO_NOT_USE Bid Manager reportable sites channel (Soon to be deprecated and please exclude channel: Non-reportable sites and apps),120x600,11.027467,2829,2235,2,0,0,0
USD,mogo marks branding drhbx gold sx,468x60,1.414642,497,402,0,0,0,0
USD,mogo marks broadwayworld sx,728x90,186.589106,7511,5008,10,23,1,22
USD,ttd entertainment sx,160x600,4207.824229,1259463,1061441,338,1291,113,1178
USD,ttd shopping sx,320x50,1961.15216,242849,226506,212,607,51,556
USD,/All Apps/Apple App Store/Sports,970x90,0.063421,41,41,0,0,0,0
USD,/All Apps/Google Play/Games/Casino,160x600,0.026306,8,8,0,0,0,0
USD,Android Top Selling Free Travel and Local,320x50,4.156717,3417,3284,13,0,0,0
USD,DO NOT USE Android Top Selling Free Media and Video,300x50,0.006756,5,5,0,0,0,0
USD,DO NOT USE Tier 3,728x90,24251.3263,4940895,4059951,2103,12601,733,11868
USD,dso custom hx,160x600,2.009694,191,171,0,8,0,8
USD,mogo marks cincinnati sx,300x250,117.718114,16039,13495,12,38,4,34
USD,mogo marks lal branding (All) silver sx,240x400,0.074475,7,5,0,0,0,0
USD,mogo marks t1 brand sx trim,970x250,6208.236528,743375,651766,1134,2026,411,1615
USD,Android Top Selling Free Social,970x250,0.086854,1,1,0,0,0,0
USD,mogo marks branding comp rate platinum video sx,300x50,71.546771,12232,11602,2,109,3,106
USD,mogo marks chicago sx,300x250,697.311597,109853,82595,65,228,20,208
USD,mogo marks elite kpi achievers sx,320x100,71.817838,9127,8542,13,13,5,8
USD,pac canada sports sx,728x90,5665.003373,857878,711961,298,2212,61,2151
USD,Android Top Selling Free Travel and Local,728x90,0.022258,12,12,0,0,0,0
USD,Cal Performances Perf Arts 5 5 black sx,728x90,11.631534,1018,884,0,0,0,0
USD,DO NOT USE OAM FR,320x50,0.717956,70,63,0,0,0,0
USD,DO NOT USE Spanish Language Sites,300x600,9.350069,4035,1283,2,1,1,0
USD,mogo jacks education sx,728x90,0.071438,16,13,0,0,0,0
USD,mogo marks kpi achievers sx,300x600,2566.765837,115803,95880,332,560,99,461
USD,mogo marks perf arts silver sx,468x60,0.004844,2,0,0,0,0,0
USD,mogo marks xsl_74205 sx ,300x600,11374.39484,1696502,1439904,1129,4940,479,4461
USD,/All Apps/Google Play/Weather,728x90,43.366907,5606,4968,10,0,0,0
USD,Channel of Top US Sites for Nielsen Video Ads - DO NOT EDIT,120x600,3.66749,900,719,0,0,0,0
USD,DO NOT USE OAM FR,728x90,1.109861,421,310,0,1,0,1
USD,DO NOT USE Tier 1* (CHANNEL),Unknown,5452.056295,162953,155927,839,110,0,110
USD,DO NOT USE Tier 1* (CHANNEL),468x60,1.63555,277,220,0,1,0,1
USD,DO NOT USE Tier 2* (CHANNEL),200x200,0.254058,96,46,0,0,0,0
USD,LSSU url v1,320x50,463.43547,45167,43635,142,236,61,175
USD,Performing Arts Fort Worth Top sx,970x250,32.084569,2001,1805,5,5,1,4
USD,mogo marks travel sx,300x50,0.059239,37,34,0,1,0,1
USD,mogo marks ttd obx kitchen premium sink sx,240x400,0.020257,3,1,0,0,0,0
USD,pac canada sports sx,320x50,5076.349254,1264798,1142460,953,1390,222,1168
USD,/All Apps/Google Play/Games/Educational,300x250,0.08826,13,13,0,0,0,0
USD,5a kpi sx,160x600,166.487824,6339,4244,4,79,0,79
USD,Duxiana - KPI sx,300x250,581.270901,177101,153921,123,18,3,15
USD,Stratford KPI revised,300x250,66.207517,7148,6402,0,165,0,165
USD,mogo marks elite kpi achievers sx,250x250,0.282655,23,14,0,0,0,0
USD,mogo marks sacramento sx,300x600,15.733156,1447,939,4,5,4,1
USD,ttd health sx,336x280,1.119684,50,39,0,0,0,0
USD,/All Apps/Apple App Store/Games/Family,300x50,2.254811,319,297,0,0,0,0
USD,Top Performing Sites,728x90,1422.956016,627208,520609,219,153,43,110
USD,mogo marks branding tier 3 sx xls37852,200x200,0.605054,42,36,0,1,0,1
USD,mogo marks houston sx,300x50,1.342848,196,187,0,2,0,2
USD,mogo marks lal (purchase) gold sx,300x600,16082.62331,1123334,988678,1435,8340,563,7777
USD,mogo marks lal (purchase) platinum sx,970x250,994.068322,65767,52634,178,532,108,424
USD,mogo marks lal branding (All) silver sx,970x66,1.011816,283,148,0,0,0,0
USD,mogo marks natl cat-aff-im sx,160x600,3378.263545,410109,342658,198,1315,68,1247
USD,mogo marks philadelphia sx,300x50,0.205836,39,39,0,0,0,0
USD,mogo marks visual arts sx,728x90,9.913686,9620,6809,6,14,0,14
USD,mogo marks xsl_74205 (2p dims) sx ,970x66,0.049335,9,4,0,0,0,0
USD,ttd health wellness sx,300x250,3024.416985,299915,240563,201,1798,58,1740
USD,ttd tech sx,120x600,0.147568,141,91,0,0,0,0
USD,/All Apps/Apple App Store/Games/Board,300x250,223.417459,25379,23585,428,19,17,2
USD,education master sx,120x600,0.777597,108,84,0,0,0,0
USD,mogo marks agg sx xsl37589,300x100,3.450582,695,618,1,0,0,0
USD,mogo marks branding max reach sx,300x250,177850.1923,37192613,29191472,18897,72139,5552,66587
USD,mogo marks native standard reach (no) tail aggregate sx,970x250,8052.844465,1108597,972790,1550,3016,545,2471
USD,mogo marks outbound kpi sx x1a,970x66,0.004991,1,0,0,0,0,0
USD,mogo marks seattle sx,970x90,1.337709,116,77,0,0,0,0
USD,mogo t1 brand sx,970x66,0.217453,37,17,0,0,0,0
USD,/All Apps/Google Play/Social,320x50,1537.750254,841962,789922,1990,96,68,28
USD,Channel of Top US Sites for Nielsen Display Ads - DO NOT EDIT,728x90,82567.43724,17123519,14033083,8588,42039,2734,39305
USD,DO NOT USE AppNexus - Collective Media,900x90,0.001275,1,1,0,0,0,0
USD,mogo marks native high reach tail aggregate sx,160x600,17487.15283,5061791,4416590,1912,8679,506,8173
USD,provident shortlist ,728x90,34667.66178,6434352,5021374,2623,15244,947,14297
USD,/All Apps/Apple App Store/Entertainment,336x280,0.039387,8,3,0,0,0,0
USD,mogo CBS Interactive sx,250x250,0.462255,83,65,1,0,0,0
USD,/All Apps/Google Play/Games/Sports,300x250,3.419954,347,287,3,0,0,0
USD,Android Top Selling Free Photography,160x600,0.394774,39,31,0,0,0,0
USD,DO NOT USE AppNexus - Collective Media,320x100,24.778527,5009,4501,25,14,8,6
USD,DO NOT USE OAM UK,970x90,0.609867,58,47,0,0,0,0
USD,Mogo DBM basic video sx,300x250,1570.120864,378024,235960,198,535,42,493
USD,mogo biz-fi sx,320x100,1.979374,374,276,2,0,0,0
USD,mogo t1 brand sx,970x90,81.578207,6177,5251,9,5,0,5
USD,ttd male sx,970x250,603.450687,145894,135996,84,126,34,92
USD,/All Apps/Apple App Store/Games/Word,336x280,0.003105,1,1,0,0,0,0
USD,Channel of Top Global Sites for Nielsen Display Ads - DO NOT EDIT,320x50,108397.5812,32150723,29758949,32167,39425,10659,28766
USD,DO NOT USE Mobile - MoPub - Jobs & Education,300x250,0.308681,252,240,1,0,0,0
USD,mogo cult soph sx,250x250,4.346333,480,429,1,1,0,1
USD,mogo marks branding tier 3 sx xls37852,336x280,4.655578,343,301,0,3,0,3
USD,mogo marks detroit sx,728x90,127.854406,51344,40533,80,82,63,19
USD,mogo marks lal (purchase) gold sx,300x50,670.107984,62770,59643,51,1816,44,1772
USD,mogo marks perf arts sx 6,970x90,0.517637,22,18,0,0,0,0
USD,mogo marks phoenix sx,250x250,0.024817,5,3,0,0,0,0
USD,/All Apps/Apple App Store/Games/Strategy,300x600,0.505745,45,44,3,2,1,1
USD,/All Apps/Apple App Store/Social Networking,300x600,1.905888,167,133,14,2,2,0
USD,/All Apps/Google Play/Games/Arcade,320x50,12.440916,7457,6826,39,6,5,1
USD,/All Apps/Google Play/News & Magazines,160x600,0.096801,4,4,0,0,0,0
USD,Pac Fox Atlanta EXCLUSION List,160x600,31.197407,19219,17551,0,7,0,7
USD,mogo canada t1 sx,250x250,10.416805,1386,1051,0,1,0,1
USD,mogo marks denver sx,160x600,44.766228,1859,1700,1,26,0,26
USD,mogo marks lal branding (All) silver sx,970x90,159.48368,11159,9693,16,19,0,19
USD,mogo marks xsl_74205 (2p dims) sx ,970x90,31.340838,2624,2328,2,3,0,3
USD,sfoc marks lal custom sx,728x90,0.510769,114,113,0,0,0,0
USD,ttd auto sx,300x250,1105.939143,56285,46524,53,233,4,229
USD,ttd health wellness sx,300x50,250.843594,26097,24908,13,971,25,946
USD,/All Apps/Apple App Store/Games/Music,300x600,0.359645,10,8,0,0,0,0
USD,Channel of Top Global Sites for Nielsen Video Ads - DO NOT EDIT,300x250,136247.5595,29445587,24017358,15512,48450,4156,44294
USD,Channel of Top non-US Sites for Nielsen Display Ads - DO NOT EDIT,970x66,0.719343,252,139,0,0,0,0
USD,Performing Arts Fort Worth Top sx,300x250,283.641491,49204,43631,24,127,6,121
USD,fgu test public channel,970x66,0.508369,179,117,0,0,0,0
USD,mogo lydia peacecenter test,970x66,0.170147,29,12,0,0,0,0
USD,mogo marks branding max reach sx,300x50,3264.594382,600195,566103,296,9657,219,9438
USD,mogo marks bwwpb sx,320x100,8.765242,445,292,0,4,0,4
USD,mogo marks native medium reach tail aggregate sx,300x600,30147.67885,3238107,2701890,3113,14117,1148,12969
USD,mogo marks ttd obx kitchen premium sink sx,970x90,260.84245,20547,17643,22,19,1,18
USD,mogo marks xsl_74205 (4p dims) sx ,970x66,0.030045,5,3,0,0,0,0
USD,sfoc pslx 2018 sx (Jun_2018_Archived),970x250,361.788333,50387,46155,89,362,76,286
USD,ttd sports sx,970x250,605.826073,31921,27156,80,177,9,168
USD,Blacklist - Verification,320x50,0.002559,5,3,0,0,0,0
USD,DO NOT USE Tier 3 (2),160x600,908.832754,252184,221205,220,584,54,530
USD,mogo marks branding comp rate silver video sx,300x600,15890.77085,1916755,1564217,2095,5314,743,4571
USD,mogo marks branding drhbx silver sx,300x600,33107.05285,3323957,2797616,3584,15144,1392,13752
USD,mogo marks video branding max reach tail aggregate sx,468x60,7.716181,2266,1652,0,0,0,0
USD,provident shortlist ,320x100,162.969605,26453,24655,60,72,21,51
USD,/All Apps/Google Play/Games/Arcade,300x50,0.371254,98,95,0,0,0,0
USD,/All Apps/Google Play/Games/Trivia,300x600,18.191406,714,675,20,1,1,0
USD,/All Apps/Google Play/Productivity,320x50,126.22776,45616,42851,92,6,4,2
USD,mogo marks bay area sx,320x50,1419.892818,251866,229356,341,475,126,349
USD,mogo marks branding comp rate silver video sx,300x100,0.026262,6,6,0,0,0,0
USD,mogo marks branding drhbx silver sx,300x100,1.023213,175,147,0,0,0,0
USD,mogo marks hq100p sx,320x50,31591.14518,7062706,6581951,8408,14608,4568,10040
USD,mogo marks native standard reach (no) tail aggregate sx,728x90,35212.1565,6401277,5131474,3328,20688,1018,19670
USD,mogo marks visual arts sx,320x50,24.983618,44897,29098,52,11,6,5
USD,/All Apps/Apple App Store/Games/Dice,300x600,0.616736,20,18,3,1,1,0
USD,/All Apps/Apple App Store/Games/Word,970x250,2.810553,276,258,4,0,0,0
USD,Performing Arts Fort Worth Perf Arts 5 black sx,320x50,12.391101,4724,4461,10,6,1,5
USD,mogo marks branding tier 3 sx xls37852,970x250,5951.5508,432070,356600,851,2062,417,1645
USD,ttd real estate sx,250x250,0.212229,13,12,0,0,0,0
USD,Nashville Symphony black list all adgroups,300x250,75.461203,7014,6083,3,119,5,114
USD,PAC Singapore sx,970x250,0.131132,13,10,0,0,0,0
USD,mogo marks branding comp rate gold video sx,320x100,28.382853,5912,5381,25,17,7,10
USD,mogo marks branding comp rate platinum video sx,336x280,10.248269,834,764,0,1,0,1
USD,mogo marks cincinnati sx,970x250,1.374746,174,104,1,0,0,0
USD,mogo marks natl elite cat-aff-im sx,250x250,0.041884,8,3,0,0,0,0
USD,mogo marks xsl66781 sx,320x50,11919.03132,3479781,3082250,2377,5382,744,4638
USD,sfoc rtx kpi sx,300x600,43.383891,3428,3090,1,28,2,26
USD,ttd news sx,250x250,8.002958,998,869,0,1,0,1
USD,ttd tech sx,300x250,2570.629028,324002,247892,333,1132,52,1080
USD,education master sx,300x250,17069.60388,2653665,2164806,2056,6343,647,5696
USD,mogo marks bay area sx,728x90,1876.75884,323431,172681,79,656,32,624
USD,mogo marks branding tier 2 sx xls37852,320x50,53414.22127,10517745,9720808,15129,23499,6533,16966
USD,mogo marks lal (purchase) platinum sx,728x90,4043.670395,360146,271833,411,1910,88,1822
USD,mogo marks natl cat-aff-im sx 2,300x100,0.153683,27,20,0,0,0,0
USD,ttd education sx,970x66,0.027595,8,3,0,0,0,0
USD,Android Top Selling Free Business,320x50,6.071328,8206,7912,13,0,0,0
USD,Channel of Top Global Sites for Nielsen Display Ads - DO NOT EDIT,120x600,9.378759,1887,1565,1,0,0,0
USD,DCPA Video black sx,300x250,4.705309,659,544,0,0,0,0
USD,DO NOT USE Tier 2,320x100,31.417254,3036,2804,9,11,5,6
USD,kid safe sx,300x100,0.065383,19,17,0,0,0,0
USD,mogo marks chicago sx,200x200,0.12326,6,6,0,0,0,0
USD,mogo marks native medium reach tail aggregate sx,300x100,0.8497,134,109,0,0,0,0
USD,mogo marks ttd obx kitchen premium sink sx,970x66,1.146605,504,156,0,0,0,0
USD,pac motorsports sx,336x280,0.854204,43,35,0,0,0,0
USD,ttd female sx,970x90,40.76247,2284,1935,2,2,0,2
USD,/All Apps/Apple App Store/Games/Card,300x250,75.139918,6670,5393,189,6,6,0
USD,DO NOT USE Tier 3,240x400,0.109962,11,6,0,0,0,0
USD,PAC Singapore sx,970x90,0.005452,2,2,0,0,0,0
USD,mogo marks natl cat-aff-im sx 2,300x250,26449.93511,3483147,2835194,3336,9309,1079,8230
USD,mogo marks perf arts silver sx,970x250,292.527982,18586,11733,48,182,69,113
USD,sfoc pslx 2018 sx (Jun_2018),320x50,2615.841218,943804,899019,960,4309,564,3745
USD,/All Apps/Apple App Store/Newsstand/Regional News,728x90,329.363298,158095,135981,81,3,1,2
USD,5a kpi sx,300x600,7.405666,292,130,0,4,0,4
USD,Duxiana - Underperformance Blacklist,300x250,229.232432,128940,105085,126,4,2,2
USD,Mogo DBM select video sx,336x280,0.06532,9,8,0,0,0,0
USD,finn dallas native sx,468x60,0.004614,1,1,0,0,0,0
USD,mogo marks disney sx,300x600,25.438343,2605,1672,0,3,0,3
USD,mogo marks video sx xsl44760 class a,300x250,11280.25215,3082030,2578936,1986,5235,562,4673
USD,/All Apps/Apple App Store/Games/Board,160x600,17.08447,674,593,84,4,3,1
USD,/All Apps/Apple App Store/Lifestyle,300x250,131.672859,55817,48050,121,3,3,0
USD,DO NOT USE Tier 1,300x50,807.618186,128638,121994,102,1950,60,1890
USD,Triad Stage Local sx,300x250,8.65275,563,458,3,0,0,0
USD,mogo marks agg sx xsl37589,300x250,171976.8778,36141267,28548343,18121,69810,5407,64403
USD,mogo marks branding comp rate gold video sx,970x90,79.187531,4736,3922,4,4,0,4
USD,mogo marks branding drhbx gold sx,970x250,4893.280618,356846,292083,700,1620,344,1276
USD,mogo marks video branding extended reach tail aggregate sx,120x600,2.672347,633,510,0,0,0,0
USD,mogo music sx,250x250,0.002154,1,1,0,0,0,0
USD,/All Apps/Google Play/Business,728x90,0.06213,104,99,1,0,0,0
USD,at iab aff-im black sx,300x250,52.439264,10582,8467,8,5,0,5
USD,kid safe sx,300x250,33163.38534,7965397,6353967,3520,11727,1021,10706
USD,maryland-dc sx,728x90,122.629163,20438,15991,8,18,5,13
USD,mogo marks branding increased reach sx,900x90,0.001275,1,1,0,0,0,0
USD,mogo marks lal (purchase) silver sx,300x100,0.907905,179,157,0,0,0,0
USD,mogo marks lal branding (All) gold sx,336x280,38.633747,1778,1585,1,21,0,21
USD,mogo marks lal branding (All) platinum sx,300x100,0.023711,4,4,0,0,0,0
USD,mogo marks natl cat-aff-im sx 3,300x50,36.113049,3642,3509,5,102,2,100
USD,mogo marks video branding medium reach tail aggregate sx,300x250,130745.5007,28480725,22938846,14268,48077,4110,43967
USD,ttd music sx,300x250,884.658144,263812,184566,111,470,38,432
USD,/All Apps/Google Play/Games/Adventure,320x50,0.95457,944,903,0,0,0,0
USD,DO NOT USE Invite US Expandable Enabled Sites,250x250,4.758739,507,454,0,0,0,0
USD,DO NOT USE Tier 1* (CHANNEL),970x250,8197.504915,958368,840311,1457,2840,550,2290
USD,DO NOT USE Tier 3 (2),300x100,0.106198,16,15,0,0,0,0
USD,mogo biz-fi sx,970x66,0.01929,4,1,0,0,0,0
USD,mogo education sx,250x250,2.870687,331,279,0,0,0,0
USD,nancy sitelist (Advertiser Level),728x90,0.045997,1,1,0,0,0,0
USD,provident shortlist ,970x66,0.856808,243,136,0,0,0,0
USD,ttd family parent sx,336x280,1.073722,143,128,0,0,0,0
USD,/All Apps,970x250,34.532836,1915,1701,34,4,4,0
USD,/All Apps/Apple App Store/Games/Action,320x50,16.347291,14084,11241,35,5,5,0
USD,/All Apps/Google Play/Games/Adventure,300x250,1.471577,174,160,4,1,1,0
USD,Android Top Selling Free News and Magazines,728x90,48.430914,21478,20002,13,0,0,0
USD,Channel of Top US Sites for Nielsen Display Ads - DO NOT EDIT,160x600,46856.06506,12592583,11169764,5340,22608,1716,20892
USD,ttd education sx,300x600,1344.202357,254370,208869,281,1068,62,1006
USD,/All Apps/Apple App Store/Games/Casino,336x280,0.039387,8,3,0,0,0,0
USD,/All Apps/Apple App Store/News,970x250,0.08924,7,5,0,0,0,0
USD,/All Apps/Google Play/Photography,300x50,0.987761,235,222,0,0,0,0
USD,mogo marks branding comp rate platinum video sx,970x66,0.072544,14,6,0,0,0,0
USD,mogo marks nyc sx,728x90,4856.75869,354325,278442,169,935,58,877
USD,mogo marks nyt sx,300x600,111.628315,8851,7140,9,32,10,22
USD,mogo marks sports sx,300x50,94.251202,21415,20291,18,69,6,63
USD,mogo marks video branding max reach tail aggregate sx,200x200,3.763663,369,245,0,1,0,1
USD,mogo marks visual arts sx,160x600,15.55735,17907,12352,16,5,1,4
USD,Pac Private Events/Wedding sx,970x250,6.240445,243,177,1,2,0,2
USD,mogo canada t1 sx,970x90,45.24288,3134,2661,5,6,0,6
USD,mogo lydia peacecenter test,300x100,0.010455,1,1,0,0,0,0
USD,sfoc marks kpi sx (062018),320x50,243.67332,89822,86268,83,571,47,524
USD,sfoc pslx 2018 sx (Jun_2018),300x250,2286.596025,491837,455173,268,3697,238,3459
USD,ttd health sx,970x66,0.0203,11,2,0,0,0,0
USD,zt local austin sx,320x50,24.185029,9985,8498,4,36,2,34
USD,/All Apps/Apple App Store/Medical,300x600,0.061876,6,3,0,0,0,0
USD,Android Top Selling Free News and Magazines,320x50,476.245823,243419,228494,266,43,13,30
USD,Portland Center Stage Perf Arts 5 black sx,320x50,0.325374,30,30,0,0,0,0
USD,mogo marks native (sharethrough) unique can sx,468x60,0.302416,103,95,0,0,0,0
USD,mogo marks t1 brand kpi sx x8t,970x90,25.063105,1783,1534,1,3,0,3
USD,DO NOT USE Spanish Language Sites,320x100,0.030964,4,4,0,0,0,0
USD,Stratford Black RT SX,320x50,5.121494,1647,1547,1,5,1,4
USD,mogo marks high intenders sx,320x50,1935.333359,300743,273946,276,1273,113,1160
USD,mogo marks kpi achievers sx,320x100,9.838465,666,493,1,4,0,4
USD,mogo marks lal (purchase) gold sx,250x250,10.949866,843,706,0,2,0,2
USD,mogo marks los angeles sx,728x90,160.833275,43901,34346,44,31,11,20
USD,Android Movers and Shakers,300x50,37.455604,5193,5039,18,0,0,0
USD,Android Top Selling Free Entertainment,970x250,0.046885,25,24,0,0,0,0
USD,DO NOT USE Tier 1,320x100,59.825599,10880,9669,31,58,7,51
USD,DO NOT USE Tier 3 (2),120x600,0.245941,119,107,0,0,0,0
USD,Triad Stage Local sx,728x90,5.606943,208,172,0,0,0,0
USD,mogo marks branding tier 3 sx xls37852,240x400,0.041756,4,4,0,0,0,0
USD,mogo marks perf arts sx 2,468x60,0.004844,2,0,0,0,0,0
USD,mogo marks video branding medium reach tail aggregate sx,728x90,56114.46206,11029035,8788022,5442,30666,1834,28832
USD,mogo music sx,160x600,107.709794,32110,28775,5,37,0,37
USD,sfoc cix sx,728x90,4.836533,442,413,1,3,0,3
USD,ttd food sx,468x60,0.008634,1,1,0,0,0,0
USD,ttd music sx,728x90,480.988866,153219,99770,39,165,8,157
USD,/All Apps/Apple App Store/Social Networking,320x100,0.001179,3,3,0,0,0,0
USD,/All Apps/Google Play/Tools,336x280,0.085925,34,26,0,0,0,0
USD,Android Top Selling Free Books and Reference,160x600,0.007101,1,1,0,0,0,0
USD,at iab aff-im black sx,728x90,0.400617,80,70,0,0,0,0
USD,kid safe sx,728x90,8568.089014,1495520,1011879,1215,2989,166,2823
USD,ttd family parent sx,250x250,1.526551,350,298,0,0,0,0
USD,/All Apps/Apple App Store,336x280,0.042493,9,4,0,0,0,0
USD,Android Top Selling Free Photography,300x50,2.095335,439,404,0,0,0,0
USD,DO NOT USE Tier 2* (CHANNEL),970x66,0.070801,68,15,0,0,0,0
USD,Duxiana - Underperformance Blacklist,728x90,217.5735,113716,101453,41,3,2,1
USD,Mogo DBM select video sx,250x250,1.495913,131,106,0,0,0,0
USD,magic theatre top performing sx,300x250,222.584245,72538,52164,127,115,64,51
USD,mogo mba tier 1 sx,336x280,0.78384,14,13,0,0,0,0
USD,t1 brand black sx,300x600,3.876587,141,131,0,0,0,0
USD,/All Apps/Google Play/Games/Puzzle,970x250,0.07866,13,13,0,0,0,0
USD,5a kpi sx,320x50,2.955195,250,142,0,4,0,4
USD,Performing Arts Fort Worth sx,728x90,61.174391,19125,18135,6,86,2,84
USD,mogo marks branding comp rate silver video sx,320x100,47.798774,7494,6874,26,21,10,11
USD,mogo marks branding drhbx silver sx,320x100,235.47871,46098,42794,67,146,25,121
USD,mogo marks branding max reach sx,970x66,1.356561,687,185,0,0,0,0
USD,mogo marks disney sx,320x50,135.456041,21860,20413,17,30,6,24
USD,mogo marks video branding max reach tail aggregate sx,300x50,2256.205354,407259,386141,228,5981,161,5820
USD,mogo marks wine sx,300x250,213.197298,27232,23305,10,143,7,136
USD,/All Apps/Google Play/Games/Card,336x280,0.032459,8,6,0,0,0,0
USD,/All Apps/Google Play/Games/Music,300x600,0.942212,132,118,0,0,0,0
USD,DCPA rt black sx,300x600,1.698895,45,40,0,0,0,0
USD,finn dallas native sx,300x600,324.643658,21589,17485,30,72,11,61
USD,mogo black rt sx,300x50,0.390367,57,54,0,0,0,0
USD,mogo cult soph sx,300x100,0.094589,19,16,0,0,0,0
USD,mogo marks agg sx xsl37589,728x90,86808.73148,16703190,13494093,8363,47160,2762,44398
USD,mogo marks branding drhbx platinum sx,728x90,6244.441964,508137,387740,282,1713,122,1591
USD,mogo marks lal (purchase) silver sx,120x600,4.846182,549,433,0,0,0,0
USD,mogo marks lal branding (All) platinum sx,120x600,1.396354,101,80,0,0,0,0
USD,mogo marks native medium reach tail aggregate sx,320x100,213.590774,30866,28731,71,94,28,66
USD,mogo marks video branding extended reach tail aggregate sx,970x250,8638.84897,1130304,984937,1631,3078,596,2482
USD,ttd gaming sx,336x280,6.942162,1941,1621,0,0,0,0
USD,at atlanta sx,300x250,32.835943,4664,4142,4,43,3,40
USD,mogo black rt sx,320x50,22.979074,3861,3380,6,0,0,0
USD,mogo canada t1 sx,970x66,0.049728,9,5,0,0,0,0
USD,mogo marks lal branding (All) silver sx,468x60,4.813489,1408,772,0,0,0,0
USD,mogo marks xsl_800p sx,320x50,78666.36364,20154986,18474056,21704,32202,8239,23963
USD,mogo music sx,320x100,0.333481,334,277,1,0,0,0
USD,/All Apps/Apple App Store/Weather,728x90,209.071842,35790,32563,80,2,1,1
USD,/All Apps/Google Play/Medical,300x250,0.093294,7,6,0,0,0,0
USD,5a local sx seattle,970x250,7.867374,2317,1932,0,0,0,0
USD,Channel of Top Global Sites for Nielsen Display Ads - DO NOT EDIT,250x250,114.627033,15596,12755,8,16,0,16
USD,DO NOT USE Tier 3,970x66,0.306756,300,14,0,0,0,0
USD,Mogo DBM premium video sx,Unknown,5452.056295,162953,155927,839,110,0,110
USD,mogo education sx,320x100,78.364123,10341,9830,15,15,6,9
USD,mogo marks classical music sx,160x600,29.0286,4344,2629,3,18,3,15
USD,mogo marks high intenders sx,300x50,9.052997,625,592,0,26,0,26
USD,mogo marks los angeles sx,300x50,2.123344,388,374,0,5,0,5
USD,mogo perf arts sx,468x60,0.004844,2,0,0,0,0,0
USD,/All Apps/Apple App Store/Games/Casino,970x250,18.305171,808,714,14,0,0,0
USD,/All Apps/Google Play,320x50,7530.270844,3727044,3518364,6320,831,508,323
USD,mogo marks branding comp rate silver video sx,336x280,15.394955,1592,1421,0,1,0,1
USD,mogo marks hq100p sx,320x51,0.8361,20,19,0,0,0,0
USD,mogo marks native medium reach tail aggregate sx,336x280,49.577177,5649,4892,0,14,0,14
USD,sfoc kpi sx (acquisition 2019),320x50,296.470247,65733,62865,91,514,63,451
USD,DO NOT USE Invite US Expandable Enabled Sites,320x100,6.527623,979,926,0,3,0,3
USD,Nashville Local sx,300x600,28.499357,2155,1886,2,71,6,65
USD,mogo marks branding drhbx silver sx,336x280,36.943502,3426,2944,0,14,0,14
USD,mogo marks branding tier 2 sx xls37852,320x51,0.8361,20,19,0,0,0,0
USD,mogo marks coupon sx,468x60,0.147028,51,10,0,0,0,0
USD,mogo marks video branding max reach tail aggregate sx,320x50,92926.55799,25970575,24117165,28352,36629,10103,26526
USD,mogo mba tier 2 sx,300x250,12987.34417,1694538,1384239,1495,3449,454,2995
USD,Android Top Selling Free News and Magazines,300x50,10.2192,2805,2705,4,0,0,0
USD,Arvada local sx,160x600,0.720084,33,27,0,0,0,0
USD,Greg's GG KPI + relevant sites list,300x600,7.091265,238,191,3,2,1,1
USD,Mogo dating sx,300x250,2.846466,681,587,0,0,0,0
USD,mogo CBS Interactive sx,970x90,0.145334,5,3,0,0,0,0
USD,mogo marks nyc sx,300x50,1.028351,105,97,0,0,0,0
USD,ttd beauty sx,300x250,446.189549,106815,83011,46,191,6,185
USD,Channel of Top Global Sites for Nielsen Video Ads - DO NOT EDIT,300x50,2183.583738,489496,466895,204,5439,141,5298
USD,Duxiana - Longtail Blacklist,300x600,96.020202,35034,30600,27,8,0,8
USD,mogo marks ballet sx,300x600,1.43773,140,103,0,0,0,0
USD,mogo marks perf arts sx 2,250x250,0.543937,46,36,0,0,0,0
USD,mogo marks xsl_ks20780 sx,300x250,156302.8307,32294087,25373543,16478,62447,4889,57558
USD,ttd finance sx,300x100,0.097726,20,17,0,0,0,0
USD,ttd shopping sx,120x600,0.150891,14,8,0,0,0,0
USD,Channel of Top US Sites for Nielsen Display Ads - DO NOT EDIT,336x280,195.926172,32794,28354,29,54,0,54
USD,DO NOT USE Mobile - MoPub - Jobs & Education,300x50,0.068684,19,19,0,0,0,0
USD,Performing Arts Fort Worth black sx,300x600,0.182246,20,10,0,0,0,0
USD,education master sx,320x50,9227.245572,2960173,2790652,2648,3793,766,3027
USD,mogo canada t1 sx,300x250,30095.33332,5335822,4391397,4195,11982,1313,10669
USD,mogo marks natl cat-aff-im sx,970x66,0.049335,9,4,0,0,0,0
USD,mogo marks t1 brand sx trim,300x50,390.589381,51254,48769,53,774,34,740
USD,provident shortlist ,336x280,31.381154,2112,1909,0,5,0,5
USD,ttd entertainment sx,240x400,0.012755,2,1,0,0,0,0
USD,DO NOT USE Invite December Brand Safe List,320x51,0.837271,21,20,0,0,0,0
USD,Seattle Local sx,160x600,1.385994,517,437,0,0,0,0
USD,mogo marks perf arts sx 7,300x250,3270.24373,206786,139942,302,1324,135,1189
USD,pac canada sports sx,120x600,0.577428,36,29,0,0,0,0
USD,/All Apps/Google Play/Games/Sports,300x50,0.077711,30,29,0,0,0,0
USD,SP News Black sx,300x600,26.062594,3309,2510,5,11,6,5
USD,dbm video sx,300x100,0.279056,47,45,0,0,0,0
USD,iab aff-im black sx,728x90,4.714728,201,188,0,0,0,0
USD,ttd food sx,250x250,4.618958,399,327,0,0,0,0
USD,ttd tech sx,320x50,1764.814867,394790,364378,506,598,106,492
USD,/All Apps/Google Play/Games/Strategy,728x90,0.2527,683,676,1,0,0,0
USD,/All Apps/Google Play/Shopping,300x250,6.558114,1401,965,1,0,0,0
USD,Android Top Selling Free Books and Reference,300x250,14.803461,4897,4362,33,7,3,4
USD,Nashville Symphony black list all adgroups,728x90,0.069546,8,7,0,0,0,0
USD,PAC Singapore Rugby sx,728x90,10.212212,637,488,1,0,0,0
USD,mogo marks native high reach tail aggregate sx,970x66,1.148657,522,158,0,0,0,0
USD,mogo marks nyc sx,468x60,0.009718,5,1,0,0,0,0
USD,/All Apps/Apple App Store/Games/Trivia,300x50,1.822819,263,243,0,0,0,0
USD,/All Apps/Apple App Store/Music,728x90,24.138517,37646,37456,26,1,1,0
USD,/All Apps/Google Play/Entertainment,300x250,8.127023,4117,2863,12,1,1,0
USD,Mogo dating sx,160x600,0.167811,22,19,0,1,0,1
USD,finn dallas native sx,970x250,85.716422,8736,4803,14,53,8,45
USD,mogo marks elite kpi achievers sx,320x50,1857.573185,158368,144032,358,904,113,791
USD,mogo sports sx,300x250,6380.205389,810481,612175,414,1478,119,1359
USD,ttd health sx,300x600,696.342615,41160,35691,57,346,12,334
USD,/All Apps/Apple App Store/Entertainment,300x600,1344.426276,75557,59209,5726,882,819,63
USD,/All Apps/Google Play/Communication,336x280,0.032804,6,4,0,0,0,0
USD,/All Apps/Google Play/Games/Role Playing,300x250,0.770555,177,158,3,0,0,0
USD,Android Top Selling Free Education,300x600,3.608628,176,148,4,2,0,2
USD,Arizona Theatre Company - Site List,300x600,17.899319,1208,949,1,2,0,2
USD,Channel of Top US Sites for Nielsen Display Ads - DO NOT EDIT,300x100,4.948046,953,846,1,0,0,0
USD,DO NOT USE OAM UK,250x250,0.064731,17,7,0,0,0,0
USD,DO NOT USE Tier 3* (CHANNEL) (2),970x66,0.000138,1,0,0,0,0,0
USD,Portland Center Stage KPI sx,160x600,0.405346,51,45,0,0,0,0
USD,at atlanta sx,160x600,0.062043,24,20,0,0,0,0
USD,mogo centro sx US (2014),120x600,0.001025,4,3,0,0,0,0
USD,/All Apps/Apple App Store/Games/Puzzle,300x600,451.87985,9227,7868,709,126,113,13
USD,/All Apps/Google Play/Music & Audio,336x280,0.035909,3,3,0,0,0,0
USD,Cal Performances sf local + t1 brand black sx,300x600,0.049364,3,3,0,0,0,0
USD,DCPA rt black sx,728x90,57.230042,2778,2393,4,24,1,23
USD,DO NOT USE Mobile - MoPub - Health,300x50,1.582702,233,201,0,0,0,0
USD,SP black sx,728x90,0.631563,30,1,0,0,0,0
USD,mogo marks video sx xsl44760 class b,728x90,6753.300846,1546934,978060,1211,2148,235,1913
USD,t1 brand black sx,970x250,1.185387,28,23,0,0,0,0
USD,ttd male sx,468x60,0.290787,76,69,0,0,0,0
USD,Arvada local sx,300x600,4.646607,187,157,0,8,0,8
USD,mogo marks branding tier 1 sx xls37852,300x250,126516.0527,27202387,21763457,13228,47515,4026,43489
USD,mogo marks kpi mdx sx xls9297,200x200,0.018275,2,1,0,0,0,0
USD,mogo marks lal branding (All) gold sx,160x600,7153.489498,739801,586023,659,4256,206,4050
USD,mogo marks native standard reach (no) tail aggregate sx,300x100,0.599074,101,85,0,0,0,0
USD,mogo marks outbound kpi sx x1a,250x250,0.539065,31,26,0,0,0,0
USD,mogo marks xsl66781 sx,300x100,0.036278,9,9,0,0,0,0
USD,ttd food sx,120x600,0.034532,7,4,0,0,0,0
USD,/All Apps/Apple App Store/Games/Simulation,300x600,1.284461,131,86,4,0,0,0
USD,Android Top Selling Free Sports,300x50,1.613877,372,348,1,1,0,1
USD,Brandcast Blacklist ,336x280,0.019374,13,12,0,0,0,0
USD,DO NOT USE Tier 3* (CHANNEL),300x50,843.068452,168269,158413,83,2633,86,2547
USD,dbm video sx,970x66,0.164733,32,8,0,0,0,0
USD,mogo centro sx US (2014),300x50,139.987892,19896,18724,13,250,17,233
USD,mogo marks wine sx,320x100,0.398697,327,306,1,0,0,0
USD,mogo marks xsl_74205 (2p dims) sx ,250x250,24.105065,3695,3014,0,2,0,2
USD,CST KPI List,300x250,31.87242,33720,26094,23,47,6,41
USD,DO NOT USE Tier 1,Unknown,5452.056295,162953,155927,839,110,0,110
USD,DO NOT USE Tier 1,468x60,1.63555,277,220,0,1,0,1
USD,mogo marks chicago sx,320x50,571.087347,203202,179683,192,178,73,105
USD,mogo marks video sx xsl44760 class c,240x400,0.010977,1,1,0,0,0,0
USD,mogo marks xsl_ks0001 sx,320x100,247.168362,50983,47210,86,148,28,120
USD,mogo sports sx,320x100,4.150851,425,395,2,9,0,9
USD,ttd health sx,970x250,190.588651,12016,10998,24,53,19,34
USD,/All Apps/Apple App Store/Book,728x90,23.467007,15649,15334,45,1,1,0
USD,/All Apps/Apple App Store/Games/Puzzle,970x250,6.914893,165,159,11,3,3,0
USD,/All Apps/Google Play/Games/Arcade,300x600,38.938338,1422,1311,72,20,19,1
USD,Western Black sx,160x600,105.386662,27799,25162,8,679,0,679
USD,mogo marks cincinnati sx,320x50,166.677138,58864,55426,20,63,6,57
USD,mogo marks playbill sx x3e,300x250,1552.647962,83044,68005,141,541,61,480
USD,/All Apps/Apple App Store/Games/Simulation,970x250,0.08544,18,12,0,0,0,0
USD,/All Apps/Google Play/Games,160x600,5.354141,962,888,12,5,4,1
USD,University of Colorado--Shortlist- HighCTR/ high CPA ,728x90,0,0,0,0,1,0,1
USD,mogo black sx,200x200,0.088739,8,8,0,0,0,0
USD,mogo marks branding drhbx silver sx,468x60,3.972146,1304,927,0,0,0,0
USD,mogo marks branding tier 1 sx xls37852,320x100,232.761807,44952,41742,69,127,29,98
USD,sfoc marks lal custom sx,300x250,5.931123,3784,3631,1,2,0,2
USD,ttd travel sx,250x250,3.029431,161,135,0,0,0,0
USD,mogo marks classical music sx,728x90,44.127356,4855,3378,3,12,0,12
USD,mogo marks native medium reach tail aggregate sx,468x60,4.57162,1165,829,0,0,0,0
USD,/All Apps/Apple App Store/Entertainment,970x250,10.697254,941,817,13,3,3,0
USD,/All Apps/Google Play/News & Magazines,250x250,0.005227,1,1,0,0,0,0
USD,Android Top Selling Free Music and Audio,160x600,0.234989,15,14,0,0,0,0
USD,Channel of Top Global Sites for Nielsen Display Ads - DO NOT EDIT,300x600,50656.29697,6443072,5389588,5498,23285,2034,21251
USD,mogo canada t1 sx,336x280,10.901767,859,788,0,1,0,1
USD,mogo cult soph sx,336x280,12.486526,949,871,0,4,0,4
USD,mogo marks branding comp rate platinum video sx,970x250,5448.169549,681822,602933,974,1659,323,1336
USD,mogo marks detroit sx,300x250,686.65444,154768,132560,132,391,60,331
USD,/All Apps/Google Play/News & Magazines,300x250,2411.258719,463424,413440,784,177,101,76
USD,/All Apps/Google Play/Transportation,320x100,0.001696,4,4,0,0,0,0
USD,DO NOT USE AppNexus - Collective Media,300x50,581.699086,89458,85053,71,1425,69,1356
USD,mogo marks native medium reach tail aggregate sx,160x600,14827.44528,4343585,3784577,1428,7442,399,7043
USD,mogo marks t1 brand sx trim,300x100,0.22996,46,37,0,0,0,0
USD,mogo sf local sx,970x250,205.944862,15940,11378,27,57,8,49
USD,mogo sports sx,200x200,0.026112,2,0,0,0,0,0
USD,mogo t1 brand sx,320x100,59.352281,13324,12055,26,50,7,43
USD,Android Top Selling Free Weather,728x90,43.382147,5574,4940,10,0,0,0
USD,BR Native sx,300x250,281.442939,31273,28527,18,84,9,75
USD,Channel of Top Global Sites for Nielsen Video Ads - DO NOT EDIT,300x100,2.904689,621,562,1,0,0,0
USD,DO NOT USE AppNexus - Collective Media,120x600,0.693029,239,161,0,0,0,0
USD,mogo marks lal (purchase) silver sx,250x250,40.652242,4558,3663,2,9,0,9
USD,mogo marks perf arts branding high reach sx,300x100,0.01794,2,2,0,0,0,0
USD,mogo marks perf arts sx 6,970x250,218.880138,12494,7029,26,137,62,75
USD,ttd entertainment sx,336x280,17.389787,1903,1612,0,2,0,2
USD,/All Apps/Google Play/Entertainment,970x250,0.042406,8,8,0,0,0,0
USD,DO NOT USE Mobile - MoPub - Arts & Entertainment/Entertainment Industry/Recording Industry,300x250,176.014529,104738,103299,83,3,3,0
USD,DO NOT USE Tier 1,160x600,9851.07543,2309830,2065763,1040,7846,413,7433
USD,DO NOT USE Tier 3* (CHANNEL),336x280,110.750351,10775,9096,6,54,0,54
USD,GG KPI sx,300x250,123.324188,5173,4391,3,9,0,9
USD,Triad Stage Perf Arts black sx,728x90,0.329417,49,44,0,0,0,0
USD,mogo marks coupon sx,728x90,165.164917,9886,5832,3,98,12,86
USD,mogo marks email sx,320x50,11.12486,4908,1338,3,1,0,1
USD,mogo marks ticketing sx,200x200,0.003722,1,1,0,0,0,0
USD,DCPA black sx,300x250,0.173555,69,61,0,0,0,0
USD,DO NOT USE Tier 3,468x60,7.036448,2567,1876,0,1,0,1
USD,mogo marks branding drhbx silver sx,160x600,11964.50533,2158326,1913598,1075,4799,286,4513
USD,/All Apps/Google Play/Games/Action,320x50,1.616137,2273,2186,19,9,9,0
USD,/All Apps/Google Play/Media & Video,970x250,0.005808,4,4,0,0,0,0
USD,Channel of Top non-US Sites for Nielsen Video Ads - DO NOT EDIT,970x90,84.465729,6618,5713,6,8,0,8
USD,DO NOT USE Tier 2,320x50,9612.850759,2554521,2373747,2458,4306,633,3673
USD,dso kpi audx sx,300x250,54.283111,4708,4366,4,141,5,136
USD,mogo marks branding comp rate gold video sx,320x50,28577.26269,6445978,6017488,9912,11693,4965,6728
USD,mogo marks lal branding (All) silver sx,728x90,39716.89933,5760378,4556283,2781,24944,974,23970
USD,mogo marks native sx xsl1045 class b,120x600,0.043904,12,5,0,0,0,0
USD,mogo marks pav kpi sx 3,300x250,8203.88629,1304660,918970,1214,2710,381,2329
USD,mogo marks perf arts platinum sx,300x50,0.84575,59,53,0,3,0,3
USD,mogo marks perf arts sx 11,970x250,218.230098,12415,6987,26,137,62,75
USD,mogo marks xsl_ks0001 sx,200x200,1.528762,230,158,0,2,0,2
USD,mogo perf arts sx,728x90,6340.918781,494829,391964,233,1445,85,1360
USD,ttd female sx,336x280,0.86495,102,91,0,0,0,0
USD,ttd shopping sx,468x60,0.148927,52,10,0,0,0,0
USD,/All Apps/Apple App Store/Productivity,300x250,0.816067,447,345,0,0,0,0
USD,Channel of Top non-US Sites for Nielsen Display Ads - DO NOT EDIT,300x50,1601.966855,313015,297471,145,4057,130,3927
USD,Duxiana - KPI sx,160x600,210.672554,135925,122753,69,6,0,6
USD,mogo financial services kpi sx,300x250,31421.84166,7839618,6492046,3210,10988,861,10127
USD,mogo marks branding elite tier sx xls37852,300x600,979.145624,64335,51372,73,495,41,454
USD,mogo marks native high reach tail aggregate sx,300x600,33837.77724,3700287,3079104,3597,15659,1363,14296
USD,mogo marks video sx xsl44760 class c,300x600,20730.62065,2393152,1993724,2498,7624,947,6677
USD,mogo marks xsl_74205 (2p dims) sx ,320x50,15557.92961,3977321,3555187,4407,6070,1239,4831
USD,mogo mba tier 2 sx,336x280,10.875668,839,768,0,1,0,1
USD,sfoc pslx 2018 sx (Jun_2018),970x250,361.788333,50387,46155,89,362,76,286
USD,ttd news sx,300x100,0.03588,5,5,0,0,0,0
USD,ttd sports sx,970x66,0.859078,244,131,0,0,0,0
USD,/All Apps/Apple App Store,728x90,2951.998114,1314206,1252895,3687,311,277,34
USD,Lynn Grad,160x600,304.100237,94060,81500,67,154,29,125
USD,mogo marks video branding extended reach tail aggregate sx,300x50,1295.540898,244209,231577,120,3711,92,3619
USD,mogo marks xsl66781 sx,970x90,31.784532,2652,2348,2,3,0,3
USD,/All Apps/Google Play/Tools,728x90,1.181637,1851,1779,2,0,0,0
USD,Stratford KPI sx,300x600,5.948177,1052,938,1,4,0,4
USD,mogo marks native standard reach (no) tail aggregate sx,970x90,180.470613,13561,11544,10,13,0,13
USD,mogo marks natl cat-aff-im sx,300x600,10073.82439,1294773,1052958,1089,3790,461,3329
USD,/All Apps/Apple App Store/Weather,250x250,0.007318,1,1,0,0,0,0
USD,/All Apps/Google Play/Business,320x100,0.039934,2,1,0,0,0,0
USD,/All Apps/Google Play/Communication,300x600,5.08047,455,417,11,0,0,0
USD,/All Apps/Google Play/Games/Adventure,728x90,0.184111,407,407,2,0,0,0
USD,/All Apps/Google Play/Transportation,320x50,16.317001,4752,4389,18,8,5,3
USD,/All Apps/Google Play/Transportation,728x90,0.053107,71,70,1,0,0,0
USD,Channel of Top US Sites for Nielsen Display Ads - DO NOT EDIT,970x90,358.968914,27215,23561,22,30,0,30
USD,cmt perf arts black sx 7,300x600,0.109911,12,10,0,0,0,0
USD,mogo marks elite kpi achievers sx,468x60,0.004844,2,0,0,0,0,0
USD,mogo marks san francisco sx,300x600,841.026525,222229,113900,69,282,30,252
USD,mogo marks toronto sx,160x600,0.640281,122,87,0,1,0,1
USD,mogo t1 brand sx,320x50,27152.36446,4719795,4408396,8886,10559,4435,6124
USD,/All Apps/Apple App Store/Travel,300x50,11.593677,2742,2615,11,0,0,0
USD,/All Apps/Google Play/Games/Card,728x90,9.101682,13794,13355,25,2,2,0
USD,Android Top Selling Free Entertainment,300x50,10.355482,2857,2758,8,0,0,0
USD,Diablo Blacklist ,160x600,2.071705,602,567,0,28,0,28
USD,mogo marks bay area sx,970x90,2.078211,184,133,0,0,0,0
USD,mogo marks kpi mdx sx xls9297,300x100,0.068771,14,14,0,0,0,0
USD,ttd gaming sx,728x90,2357.667514,722502,562498,437,758,155,603
USD,/All Apps/Apple App Store/Food & Drink,300x250,16.517964,6622,6019,5,0,0,0
USD,/All Apps/Apple App Store/Games/Casino,300x600,268.582128,14627,12853,1034,103,89,14
USD,Lynn DMAC,336x280,0.108963,3,3,0,0,0,0
USD,mogo music sx,300x250,217.706308,49790,36771,18,109,9,100
USD,ttd male sx,336x280,2.606369,562,416,0,2,0,2
USD,ttd sports sx,336x280,2.046881,223,177,0,0,0,0
USD,/All Apps/Google Play/Games/Educational,728x90,1.739534,557,548,3,2,2,0
USD,SP black sx,160x600,0.575998,650,481,0,0,0,0
USD,Stratford KPI revised,728x90,39.801062,8841,8244,9,82,4,78
USD,mogo marks branding increased reach sx,970x250,11747.63052,1441351,1256960,2119,4110,760,3350
USD,mogo marks branding max reach sx,728x90,90540.25482,17544225,14155856,8772,49164,2879,46285
USD,mogo marks sacramento sx,320x50,578.470654,154752,142533,161,168,56,112
USD,mogo marks video sx xsl44760 class b,160x600,6470.028061,1946865,1752115,543,1449,202,1247
USD,ttd health sx,250x250,6.154121,541,432,0,1,0,1
USD,/All Apps/Apple App Store/Newsstand,300x250,667.193542,235698,199685,260,12,5,7
USD,Channel of Top non-US Sites for Nielsen Display Ads - DO NOT EDIT,970x90,158.201672,11289,9582,13,17,0,17
USD,education master sx,970x250,4430.134788,310080,258006,602,1216,220,996
USD,ttd health wellness sx,728x90,1839.046916,168856,134199,78,1346,27,1319
USD,ttd travel sx,320x100,3.039349,326,297,0,0,0,0
USD,5a local sx seattle,300x600,13.17633,1325,1131,0,0,0,0
USD,DCPA Video black sx,970x250,0.779341,126,104,1,0,0,0
USD,DO NOT USE Invite US Expandable Enabled Sites,300x250,3343.674253,852221,712284,328,1594,101,1493
USD,mogo education sx,300x250,2147.47336,578111,481591,353,1341,135,1206
USD,mogo marks elite kpi achievers sx,160x600,7784.822159,1567911,1406668,872,2217,333,1884
USD,mogo marks video sx xsl44760 class c,970x66,0.284439,100,27,0,0,0,0
USD,ttd tech sx,970x250,232.564392,15795,13920,35,60,21,39
USD,bbb kpi sx (2019),300x250,133.365499,8143,7457,10,109,8,101
USD,mogo marks branding comp rate platinum video sx,250x250,11.605257,1618,1241,0,2,0,2
USD,mogo marks lal (purchase) gold sx,320x50,28847.66138,4671201,4348898,7153,14028,4217,9811
USD,mogo marks perf arts sx 5 epx1,300x50,1.52171,116,107,0,6,0,6
USD,DO NOT USE Tier 1* (CHANNEL),300x250,80296.77336,15031527,11964228,9177,31358,2893,28465
USD,DO NOT USE fgu test public channel,970x250,693.468239,46601,40440,108,153,23,130
USD,Lynn Undergrad,160x600,401.087618,73692,70338,26,267,9,258
USD,dbm native sx (adx),300x600,10080.49688,1110728,952946,1150,3302,369,2933
USD,dbm video sx,320x100,18.75907,4911,4397,24,25,7,18
USD,mogo black sx,970x66,0.022867,6,0,0,0,0,0
USD,mogo marks pav kpi sx 2,468x60,0.004844,2,0,0,0,0,0
USD,pac motorsports sx,970x66,0.675292,206,129,0,0,0,0
USD,ttd beauty sx,300x50,1.380931,134,127,0,4,0,4
USD,/All Apps/Google Play/Travel & Local,300x600,0.869151,56,52,2,0,0,0
USD,DO NOT USE Mobile - MoPub - Arts & Entertainment,970x250,0.107114,1,1,0,0,0,0
USD,mogo marks coupon sx,300x100,0.007841,1,1,0,0,0,0
USD,mogo marks xsl66781 sx,160x600,3250.261545,431024,354446,179,1136,62,1074
USD,ocfta local madison sx,160x600,40.363422,1934,1819,0,19,0,19
USD,ttd weather sx,468x60,0.004684,2,2,0,0,0,0
USD,/All Apps/Apple App Store/News,728x90,515.187617,275854,243049,191,9,5,4
USD,/All Apps/Apple App Store/Photo & Video,300x600,0.684649,79,70,5,0,0,0
USD,/All Apps/Google Play/Games/Simulation,300x250,8.571824,497,445,23,1,1,0
USD,DCPA display local sx,970x250,2.637237,105,79,1,2,2,0
USD,DO NOT USE Tier 3,970x90,147.189078,11847,10387,12,12,0,12
USD,mogo marks bay area sx,160x600,44.139932,3376,2188,4,20,1,19
USD,mogo marks native sx xsl1045 class c,320x100,105.818537,12591,11881,24,31,15,16
USD,mogo marks perf arts sx 7,970x90,0.523822,32,28,0,0,0,0
USD,ttd finance sx,320x100,3.751882,901,743,5,3,2,1
USD,DO NOT USE Mobile - MoPub - Online Communities,728x90,0.007389,3,3,0,0,0,0
USD,DO NOT USE Tier 2,300x100,0.185068,46,42,0,0,0,0
USD,mogo marks broadwayworld sx,970x90,0.442692,15,12,0,0,0,0
USD,mogo marks seattle sx,300x250,519.125626,126397,96533,52,97,4,93
USD,mogo marks wine sx,320x50,265.16818,96761,90551,27,201,6,195
USD,mogo marks xsl_800p sx,200x200,2.474974,316,244,0,2,0,2
USD,mogo mba tier 2 sx,300x50,205.989754,21958,21030,22,410,8,402
USD,/All Apps,728x90,3165.759514,1454034,1387409,3868,327,292,35
USD,/All Apps/Apple App Store/Education,300x600,16.430036,455,274,24,0,0,0
USD,/All Apps/Apple App Store/Games/Card,336x280,0.039387,8,3,0,0,0,0
USD,/All Apps/Apple App Store/Games/Sports,300x250,0.978547,285,243,2,0,0,0
USD,DO NOT USE Tier 3* (CHANNEL) (2),320x100,17.068311,1353,1202,3,9,0,9
USD,magic theatre top performing sx,320x50,169.981132,86934,75898,181,148,132,16
USD,mogo marks native standard reach (no) tail aggregate sx,160x600,12520.42761,3177602,2801266,1106,6696,316,6380
USD,mogo marks natl canada cat-aff-im sx,300x600,1890.589666,181371,154495,179,1075,107,968
USD,mogo marks video branding max reach tail aggregate sx,970x250,10851.43706,1386969,1211998,1950,3805,731,3074
USD,ttd spanish sx,160x600,40.282728,9857,8452,15,11,2,9
USD,/All Apps/Google Play/Games,300x600,539.541565,22021,19866,608,209,190,19
USD,Channel of Top Global Sites for Nielsen Video Ads - DO NOT EDIT,240x400,0.08357,10,5,0,0,0,0
USD,mogo mba tier 2 sx,970x250,4148.7507,294420,245711,510,1139,214,925
USD,/All Apps,336x280,0.577415,151,108,1,2,2,0
USD,/All Apps/Google Play/Photography,320x50,25.957717,36120,34522,87,8,7,1
USD,Channel of Top Global Sites for Nielsen Display Ads - DO NOT EDIT,900x90,0.015264,14,8,0,0,0,0
USD,fgu test public channel,300x600,51.412634,6352,4968,9,13,3,10
USD,mogo marks xsl_74205 (4p dims) sx ,300x600,6909.948365,1165659,968904,602,3276,270,3006
USD,mogo t1 brand sx,120x600,0.570847,75,61,0,0,0,0
USD,ttd health sx,970x90,4.420964,1037,935,2,2,0,2
USD,/All Apps/Apple App Store,300x50,78.405877,17013,16127,44,2,0,2
USD,/All Apps/Apple App Store/Entertainment,970x90,0.063421,41,41,0,0,0,0
USD,African American Interests sx,300x600,0.26151,30,25,0,0,0,0
USD,DO NOT USE OAM UK,300x50,3.834508,426,409,0,21,0,21
USD,mogo marks natl cat-aff-im sx 3,300x250,13727.83343,1790824,1452670,1929,5592,668,4924
USD,mogo marks xsl_74205 (2p dims) sx ,120x600,0.145074,17,15,0,0,0,0
USD,mogo mba tier 1 sx,300x50,31.441101,3249,3132,5,92,2,90
USD,/All Apps/Google Play/Games/Casino,320x50,1.476562,1593,1569,11,6,5,1
USD,/All Apps/Google Play/Photography,728x90,0.257585,328,321,0,0,0,0
USD,Belmont Sitelist v1,300x250,429.143053,91510,85019,39,161,37,124
USD,DO NOT USE OAM UK,120x600,0.473636,45,30,0,0,0,0
USD,Duxiana Broadcast blacklist,728x90,1.359447,1218,1174,1,0,0,0
USD,Mercury Theater Chicago sx,300x600,58.320729,18629,14567,16,24,12,12
USD,Pac Private Events/Wedding sx,336x280,0.377752,59,47,0,0,0,0
USD,Western Black sx,300x250,261.470984,63769,59335,18,970,9,961
USD,mogo marks lal (purchase) gold sx,320x51,0.8361,20,19,0,0,0,0
USD,mogo marks sports sx,728x90,4325.40951,589771,471101,211,841,33,808
USD,ttd travel sx,468x60,0.238899,91,60,0,0,0,0
USD,/All Apps/Google Play/Games/Card,300x50,4.070267,293,288,0,0,0,0
USD,/All Apps/Google Play/Transportation,300x50,0.11362,21,20,0,0,0,0
USD,mogo marks branding elite tier sx xls37852,300x100,0.007841,1,1,0,0,0,0
USD,mogo marks lal branding (All) gold sx,320x100,88.839515,19380,17838,17,72,4,68
USD,mogo marks perf arts sx 5 epx1,250x250,0.131271,18,13,0,0,0,0
USD,mogo marks video sx xsl44760 class c,300x100,0.279892,58,54,0,0,0,0
USD,mogo t1 brand sx,300x50,392.815057,51502,49004,53,779,34,745
USD,ttd beauty sx,970x250,31.667881,3289,2711,6,9,1,8
USD,ttd gaming sx,300x50,66.249565,15348,14532,7,177,5,172
USD,/All Apps/Google Play/Games/Word,320x50,231.36163,159136,154631,194,64,35,29
USD,DO NOT USE AppNexus - Collective Media,240x400,0.030732,6,1,0,0,0,0
USD,DO NOT USE Invite US Expandable Enabled Sites,200x200,0.009995,1,1,0,0,0,0
USD,Fan Extender IMG/Sidearm Blacklist,970x66,0.062353,27,5,0,0,0,0
USD,mogo education sx,200x200,0.017397,1,1,0,0,0,0
USD,mogo marks branding tier 2 sx xls37852,300x50,1313.780185,163822,155399,99,3956,75,3881
USD,mogo marks pav kpi hx,320x100,9.101814,2375,2112,6,4,3,1
USD,/All Apps/Apple App Store/Games,728x90,1888.027464,856267,834861,3193,290,263,27
USD,Channel of Top US Sites for Nielsen Video Ads - DO NOT EDIT,728x90,68021.32508,14374669,11779513,7002,34624,2339,32285
USD,DO NOT USE Mobile - MoPub - Games/Computer & Video Games/Music & Dance Games,300x250,176.014529,104738,103299,83,3,3,0
USD,mogo marks coupon sx,160x600,26.127371,1411,1000,1,4,0,4
USD,mogo marks lal branding (All) gold sx,120x600,2.021057,207,167,0,0,0,0
USD,mogo marks sports sx,300x600,441.983515,26264,22923,47,74,8,66
USD,/All Apps/Google Play/Productivity,300x50,10.515516,1455,1397,6,3,0,3
USD,Duxiana Broadcast blacklist,300x600,0.037783,30,18,0,0,0,0
USD,dbm video sx,320x50,23759.23925,4355749,4055065,7441,9943,4158,5785
USD,mogo marks hq100p sx,300x50,542.660457,72552,68964,65,1362,61,1301
USD,mogo marks native sx xsl1045 class c,320x50,26601.70782,7719016,7243995,6963,9399,2084,7315
USD,mogo marks perf arts silver sx,300x600,463.462998,29589,19858,29,137,32,105
USD,mogo marks shakespeare sx,970x90,0.08113,17,16,0,0,0,0
USD,mogo perf arts sx,160x600,1521.449504,90812,65709,58,477,23,454
USD,ttd finance sx,320x50,1720.896938,510218,464444,424,579,125,454
USD,/All Apps/Google Play/Games/Word,728x90,31.292996,31943,31056,32,7,6,1
USD,Android Top Selling Free Business,300x50,0.098904,73,70,0,0,0,0
USD,Channel of Top US Sites for Nielsen Display Ads - DO NOT EDIT,320x51,0.837271,21,20,0,0,0,0
USD,DO NOT USE Tier 2,160x600,1327.787855,257102,219341,196,894,46,848
USD,DO NOT USE Tier 3* (CHANNEL),970x66,0.306756,300,14,0,0,0,0
USD,DO NOT USE Tier 3* (CHANNEL) (2),320x50,2145.245955,653955,603383,707,936,217,719
USD,Mogo DBM select video sx,300x50,18.836034,2414,2257,2,59,1,58
USD,RCU Blacklist Sites (CPA),728x90,4.243467,520,481,0,1,0,1
USD,mogo cult soph sx,970x66,0.056764,14,4,0,0,0,0
USD,mogo marks bw-theatre sx,300x250,35.730826,2282,1811,8,18,2,16
USD,mogo marks wedding sx,320x100,0.152001,14,13,0,0,0,0
USD,mogo t1 brand sx,300x100,0.260802,52,43,0,0,0,0
USD,pac motorsports sx,320x100,0.280594,141,109,0,0,0,0
USD,provident shortlist ,320x51,0.001171,1,1,0,0,0,0
USD,ttd shopping sx,336x280,0.249017,37,33,0,0,0,0
USD,/All Apps/Apple App Store/Shopping,300x250,2.760709,419,304,0,0,0,0
USD,/All Apps/Google Play/Health & Fitness,320x50,53.87499,23643,19699,20,15,1,14
USD,BBB perf arts 5 black sx,300x600,12.74423,1197,1120,1,20,0,20
USD,DO_NOT_USE Bid Manager reportable sites channel (Soon to be deprecated and please exclude channel: Non-reportable sites and apps),728x90,91039.23842,18546691,15155214,12164,47281,3144,44137
USD,mogo marks natl cat-aff-im sx 3,468x60,0.004844,2,0,0,0,0,0
USD,mogo marks perf arts sx 2,320x100,10.461372,695,476,1,4,0,4
USD,stratford black OB sx,320x50,0.01403,2,2,0,0,0,0
USD,/All Apps/Apple App Store/Games/Casino,728x90,538.418905,266209,261112,836,75,68,7
USD,DO_NOT_USE Mobile - MoPub - Games,300x250,2.988171,381,350,1,0,0,0
USD,DSM African American sx,300x600,1.418632,100,82,0,0,0,0
USD,mogo marks branding comp rate platinum video sx,160x600,3011.629933,869975,834701,230,545,86,459
USD,mogo marks native (sharethrough) unique us sx,300x600,4807.771909,601453,497649,614,2037,184,1853
USD,mogo marks native standard reach (no) tail aggregate sx,240x400,0.012357,1,1,0,0,0,0
USD,mogo marks travel sx,160x600,258.690156,52639,43804,40,431,17,414
USD,mogo universal rt+ob black sx,336x280,0.007188,2,1,0,0,0,0
USD,pac canada sports sx,970x66,0.756753,225,133,0,0,0,0
USD,Channel of Top non-US Sites for Nielsen Video Ads - DO NOT EDIT,250x250,48.068889,6751,5573,5,4,0,4
USD,DO NOT USE Tier 1,336x280,31.648695,2369,2069,0,21,0,21
USD,South Coast Rep Perf Arts 5 black sx,320x50,1.341599,208,199,0,1,0,1
USD,dbm native sx (adx),300x100,0.01587,3,3,0,0,0,0
USD,mogo marks native sx xsl1045 class a,320x50,6686.888605,2226512,2067615,1424,2729,456,2273
USD,mogo marks natl cat-aff-im sx 3,336x280,1.598944,60,46,0,1,0,1
USD,ttd health sx,160x600,674.236958,77121,63305,59,450,9,441
USD,/All Apps/Apple App Store/Business,300x600,1.704096,47,43,6,0,0,0
USD,/All Apps/Apple App Store/Games,160x600,172.707834,3806,3606,624,18,17,1
USD,/All Apps/Apple App Store/Games/Card,970x250,23.897759,968,868,23,3,3,0
USD,/All Apps/Apple App Store/Sports,320x50,318.645026,166066,148850,224,4,1,3
USD,/All Apps/Google Play/Books & Reference,320x50,112.18174,41446,39048,101,36,22,14
USD,5a local sx seattle,728x90,4.296761,994,881,0,2,0,2
USD,mogo marks branding drhbx platinum sx,200x200,0.239146,20,16,0,0,0,0
USD,mogo marks branding tier 1 sx xls37852,300x100,0.783354,145,127,0,0,0,0
USD,mogo marks natl elite cat-aff-im sx,970x90,20.586896,1573,1361,2,3,0,3
USD,mogo marks perf arts sx 11,468x60,0.004844,2,0,0,0,0,0
USD,mogo marks video branding medium reach tail aggregate sx,200x200,3.583949,357,236,0,1,0,1
USD,/All Apps/Google Play/Lifestyle,970x250,0.006383,1,1,0,0,0,0
USD,DO_NOT_USE Bid Manager reportable sites channel (Soon to be deprecated and please exclude channel: Non-reportable sites and apps),900x90,0.001275,1,1,0,0,0,0
USD,at iab aff-im black sx,970x250,6.095354,275,240,0,0,0,0
USD,mogo marks perf arts sx 6,468x60,0.004844,2,0,0,0,0,0
USD,sfoc stratford hqcat sx,300x600,363.82008,40202,37085,55,499,45,454
USD,/All Apps/Apple App Store/Lifestyle,970x250,0.154042,5,5,0,0,0,0
USD,Broadway sx,728x90,3.748491,113,103,0,4,0,4
USD,kid safe sx,200x200,0.151404,11,11,0,1,0,1
USD,mogo marks ballet sx,320x100,0.007906,1,0,0,0,0,0
USD,mogo marks perf arts sx 5 epx1,320x100,13.487068,1114,851,1,11,0,11
USD,mogo marks video sx xsl44760 class a,970x250,439.753199,262944,248723,221,288,27,261
USD,/All Apps/Apple App Store/Newsstand/News & Politics,728x90,329.543612,158418,136163,81,3,1,2
USD,/All Apps/Google Play/Media & Video,300x50,0.595947,115,110,0,0,0,0
USD,dbm video sx,970x90,78.795383,5032,4254,4,7,0,7
USD,mogo marks perf arts sx 11,300x50,0.581775,46,40,0,0,0,0
USD,ttd female sx,728x90,5472.958107,927996,822763,301,2724,114,2610
USD,ttd tech sx,468x60,0.244571,133,71,0,0,0,0
USD,Android Top Selling Free Sports,728x90,0.011462,20,20,0,0,0,0
USD,DO NOT USE Tier 3* (CHANNEL),728x90,24251.3263,4940895,4059951,2103,12601,733,11868
USD,education master sx,468x60,0.347125,116,80,0,0,0,0
USD,mogo lydia peacecenter test,300x250,60015.29506,14234108,11627325,6269,18949,1824,17125
USD,mogo marks lal (purchase) platinum sx,300x600,5854.057766,285703,247975,573,2109,179,1930
USD,mogo marks pav kpi sx,200x200,0.014553,1,0,0,0,0,0
USD,/All Apps/Google Play/Games/Racing,300x50,0.170085,38,37,0,0,0,0
USD,DO NOT USE Invite December Brand Safe List,970x250,3110.166811,691124,624333,891,1147,278,869
USD,dso custom hx,728x90,28.125536,4641,4340,1,58,0,58
USD,mogo centro sx US (2014),320x50,13275.50777,3175715,2943340,4229,4660,1461,3199
USD,mogo marks playbill 5 sx x9z,970x250,66.831432,7011,3437,9,44,4,40
USD,ttd entertainment sx,728x90,14595.27781,2961488,2468707,1142,5476,384,5092
USD,/All Apps/Google Play/Sports,320x50,599.394576,287516,268586,292,28,18,10
USD,DO NOT USE Tier 2,120x600,0.150018,134,81,0,0,0,0
USD,Mogo DBM premium video sx,300x50,577.433024,72516,69063,43,1614,24,1590
USD,ttd finance sx,970x90,17.600655,808,703,1,2,0,2
USD,/All Apps/Apple App Store/Book,300x50,2.297279,662,647,0,2,0,2
USD,/All Apps/Apple App Store/Games/Trivia,728x90,8.288522,5914,5819,13,1,0,1
USD,/All Apps/Apple App Store/Reference,320x50,257.926395,92827,88267,230,5,3,2
USD,DO NOT USE Mobile - MoPub - Health,320x50,12.455693,6802,6667,5,1,1,0
USD,DO NOT USE fgu test public channel,970x90,23.125749,967,845,2,0,0,0
USD,Mogo DBM premium video sx,120x600,0.419371,39,33,0,0,0,0
USD,mogo marks native standard reach (no) tail aggregate sx,300x600,25462.71296,2669493,2230204,2639,11976,969,11007
USD,ttd family parent sx,970x66,0.012075,3,0,0,0,0,0
USD,ttd kids sx,970x250,96.218352,3358,3017,17,39,3,36
USD,tz - Local Seattle sx,728x90,6.360365,2407,1862,0,11,0,11
USD,/All Apps/Apple App Store/News,970x90,0.008705,5,5,0,0,0,0
USD,/All Apps/Apple App Store/Newsstand/News & Politics,970x250,0.064745,4,2,0,0,0,0
USD,/All Apps/Apple App Store/Photo & Video,728x90,9.602268,9987,9897,11,2,2,0
USD,DO NOT USE Mobile - MoPub - Computers & Electronics/Consumer Electronics/GPS & Navigation,320x50,0.098481,169,163,0,0,0,0
USD,Top Performing Sites,300x600,917.00302,206002,157377,79,91,7,84
USD,mogo marks perf arts sx 5 rx1,300x600,310.88776,24653,14525,34,92,21,71
USD,mogo marks video branding extended reach tail aggregate sx,240x400,0.019634,2,2,0,0,0,0
USD,mogo marks xsl_74205 sx ,970x90,31.489691,2629,2333,2,3,0,3
USD,ttd health wellness sx,468x60,0.086391,47,29,0,0,0,0
USD,/All Apps/Google Play/Education,300x250,1.534319,465,412,0,0,0,0
USD,/All Apps/Google Play/Photography,320x100,0.000374,1,1,0,0,0,0
USD,/All Apps/Google Play/Tools,160x600,0.524937,66,64,0,0,0,0
USD,Android Top Selling Free Weather,300x50,28.945023,4905,4597,7,2,0,2
USD,Channel of Top US Sites for Nielsen Display Ads - DO NOT EDIT,300x600,53382.22285,6811865,5686628,5757,24457,2090,22367
USD,DO NOT USE Rubicon,200x200,0.066638,7,7,0,0,0,0
USD,mogo marks branding increased reach sx,Unknown,5452.056295,162953,155927,839,110,0,110
USD,mogo marks disney sx,250x250,0.02783,2,1,0,0,0,0
USD,mogo marks natl canada cat-aff-im sx,728x90,6563.213262,668009,468360,263,2242,105,2137
USD,mogo marks video sx xsl44760 class b,336x280,2.506815,662,542,0,1,0,1
USD,ttd entertainment sx,970x250,4881.684779,540401,468642,736,1509,327,1182
USD,ttd weather sx,300x250,2008.514904,290666,154016,186,790,84,706
USD,/All Apps/Google Play/Finance,300x250,10.78394,506,439,1,1,0,1
USD,/All Apps/Google Play/Travel & Local,728x90,0.026485,30,29,0,0,0,0
USD,DO NOT USE Tier 2,300x50,487.341027,67575,64249,27,1831,17,1814
USD,Pac Private Events/Wedding sx,970x90,0.352285,12,7,0,0,0,0
USD,mogo marks branding increased reach sx,468x60,13.002013,4376,2990,0,1,0,1
USD,mogo marks branding max reach sx,468x60,14.660785,4915,3448,0,2,0,2
USD,mogo marks jazz & blues sx,250x250,0.002154,1,1,0,0,0,0
USD,mogo marks pav kpi sx 2,300x250,23444.85396,3147151,2424339,3000,8073,934,7139
USD,ttd food sx,320x50,7501.412557,1576680,1496215,1079,4172,374,3798
USD,/All Apps/Apple App Store/Games/Arcade,320x50,5.919579,3974,3879,14,2,2,0
USD,/All Apps/Google Play/Comics,300x50,0.001725,1,1,0,0,0,0
USD,Android Top Selling Free Tools,300x250,101.509759,17329,13546,83,12,9,3
USD,DO NOT USE Spanish Language Sites,970x90,0.114737,9,8,0,0,0,0
USD,dbm native sx (adx),728x90,7016.659314,1368922,950046,1248,2711,181,2530
USD,mogo marks kpi achievers sx,970x90,24.51554,1056,920,4,3,0,3
USD,mogo marks perf arts gold sx,250x250,0.120817,17,12,0,0,0,0
USD,mogo perf arts sx,300x50,21.567804,3181,2977,4,51,2,49
USD,sfoc rtx kpi sx,160x600,89.96701,8935,8297,42,70,19,51
USD,ttd female sx,970x250,388.583718,87561,81123,145,200,41,159
USD,/All Apps/Google Play/Games/Trivia,160x600,0.031875,3,3,0,0,0,0
USD,DO NOT USE Invite December Brand Safe List,200x200,1.206739,166,108,0,1,0,1
USD,DO NOT USE Tier 3* (CHANNEL),970x250,1367.424978,327177,287715,331,559,148,411
USD,RCU KPI Sitelist 1 (CPA),300x600,26.420519,1176,1086,1,3,0,3
USD,dso custom hx,970x250,10.111398,344,310,0,3,0,3
USD,mogo financial services kpi sx,250x250,27.041902,4198,3434,1,5,0,5
USD,mogo marks branding comp rate gold video sx,120x600,1.467405,264,214,0,0,0,0
USD,mogo marks branding drhbx platinum sx,240x400,0.009242,1,1,0,0,0,0
USD,mogo marks coupon sx,300x50,1.143289,62,57,0,1,0,1
USD,mogo marks lal branding (All) gold sx,970x66,0.25231,53,22,0,0,0,0
USD,mogo marks shakespeare sx,336x280,0.108503,4,4,0,0,0,0
USD,mogo marks video branding medium reach tail aggregate sx,240x400,0.096434,7,7,0,0,0,0
USD,provident shortlist ,300x600,26072.23511,3178353,2661944,2670,10889,1021,9868
USD,ttd kids sx,200x200,0.066638,7,7,0,0,0,0
USD,Android Movers and Shakers,728x90,0.988242,499,478,6,0,0,0
USD,Brandcast Blacklist ,970x250,426.184646,35070,30248,71,39,15,24
USD,Channel of Top non-US Sites for Nielsen Video Ads - DO NOT EDIT,240x400,0.029206,2,1,0,0,0,0
USD,DCPA black sx,728x90,0.020125,1,1,0,0,0,0
USD,at black perf arts sx 7,728x90,0.919097,271,213,0,0,0,0
USD,mogo marks native sx xsl1045 class a,320x100,1.907481,170,151,1,4,4,0
USD,mogo marks t1 brand kpi sx x8t,300x600,5953.725384,594059,531070,619,2457,289,2168
USD,/All Apps,160x600,179.163447,4876,4596,637,23,21,2
USD,/All Apps/Apple App Store/Sports,320x100,0.11385,21,20,0,0,0,0
USD,/All Apps/Google Play/Books & Reference,320x100,0.005491,6,6,0,0,0,0
USD,/All Apps/Google Play/Games/Board,320x50,14.206605,23237,22760,28,0,0,0
USD,DO NOT USE Mobile - MoPub - Online Communities,160x600,0.028123,3,2,0,0,0,0
USD,Greg's GG KPI + relevant sites list,300x250,29.035546,1207,877,4,9,0,9
USD,NYPR whitelist sx (Advertiser Level),160x600,9.626855,368,336,0,0,0,0
USD,mogo financial services kpi sx,320x100,12.642547,1606,1423,3,5,0,5
USD,mogo marks seattle sx,250x250,0.059257,6,6,0,0,0,0
USD,mogo marks video sx xsl44760 class b,300x50,49.185744,8813,8409,3,74,1,73
USD,ttd finance sx,160x600,553.505104,89217,76449,40,177,13,164
USD,/All Apps/Apple App Store/News,160x600,0.013771,1,1,0,0,0,0
USD,/All Apps/Google Play/Personalization,728x90,0.040432,91,89,0,0,0,0
USD,Android Top Selling Free Photography,728x90,0.075435,78,70,0,0,0,0
USD,Channel of Top non-US Sites for Nielsen Display Ads - DO NOT EDIT,336x280,83.40577,14015,12072,9,26,0,26
USD,DO NOT USE Microsoft Bin (001),320x50,0.180334,81,56,0,0,0,0
USD,DO NOT USE Tier 3 (2),728x90,2359.288383,457317,381954,246,2153,102,2051
USD,Pac Private Events/Wedding sx,160x600,1.521999,232,162,0,1,0,1
USD,mogo canada t1 sx,300x600,9248.174483,890595,784883,1067,3398,362,3036
USD,mogo marks perf arts branding high reach sx,970x90,2.664143,126,85,0,0,0,0
USD,mogo marks phoenix sx,300x600,154.899298,16042,10841,15,23,5,18
USD,mogo marks shakespeare sx,300x50,0.044706,4,3,0,0,0,0
USD,mogo marks toronto sx,970x90,1.216546,479,403,1,1,0,1
USD,mogo marks xsl_74205 sx ,160x600,5062.065923,1090930,967312,451,2055,131,1924
USD,ttd health sx,300x100,0.096984,10,2,0,0,0,0
USD,/All Apps/Google Play/Communication,970x250,0.00138,1,1,0,0,0,0
USD,/All Apps/Google Play/News & Magazines,728x90,53.027278,23042,21482,15,0,0,0
USD,Android Top Selling Free Tools,336x280,0.089921,35,27,0,0,0,0
USD,DCPA black sx,320x50,0.161772,50,46,0,0,0,0
USD,DO NOT USE Mobile - MoPub - Computers & Electronics/Software/Multimedia Software/Audio & Music Software,300x250,176.014529,104738,103299,83,3,3,0
USD,Nashville Local sx,300x250,93.140834,9113,7957,4,165,6,159
USD,Pac Fox Atlanta EXCLUSION List,728x90,652.731989,114279,100646,67,111,11,100
USD,mogo marks branding elite tier sx xls37852,200x200,0.224321,19,15,0,0,0,0
USD,mogo marks denver sx,728x90,545.546087,49337,40121,39,303,13,290
USD,mogo marks lal branding (All) platinum sx,728x90,5054.805707,681758,499582,387,2792,183,2609
USD,mogo marks perf arts gold sx,320x100,9.356745,516,338,0,4,0,4
USD,mogo marks playbill 5 sx x9z,300x250,1554.379107,83242,68113,141,543,61,482
USD,DO NOT USE Spanish Language Sites,160x600,9.352106,2927,2365,6,4,2,2
USD,mogo cult soph sx,300x600,9457.85029,923059,786350,1048,3183,369,2814
USD,mogo lydia peacecenter test,336x280,14.452686,1628,1427,3,1,0,1
USD,mogo marks branding tier 3 sx xls37852,468x60,0.375324,143,93,0,0,0,0
USD,mogo marks kpi achievers sx,160x600,1908.142359,138159,110833,84,739,29,710
USD,mogo marks native high reach tail aggregate sx,200x200,1.957113,277,157,0,2,0,2
USD,mogo marks video sx xsl44760 class c,200x200,2.290024,160,103,0,1,0,1
USD,/All Apps/Google Play/Games/Casual,160x600,0.784999,168,165,1,1,0,1
USD,DO NOT USE Invite December Brand Safe List,240x400,0.007502,1,0,0,0,0,0
USD,mogo marks broadway sx,320x100,9.968234,606,419,0,4,0,4
USD,mogo marks houston sx,320x50,247.920411,50721,43856,53,42,4,38
USD,mogo marks outbound kpi sx x1a,970x90,24.51554,1056,920,4,3,0,3
USD,mogo marks perf arts platinum sx,320x100,8.76783,446,292,0,4,0,4
USD,mogo marks t1 brand kpi sx x8t,250x250,1.201748,294,231,0,0,0,0
USD,pac canada sports sx,300x250,7746.954125,1047533,814058,636,2573,235,2338
USD,/All Apps/Apple App Store/Catalogs,320x50,1.288456,485,463,1,0,0,0
USD,/All Apps/Apple App Store/Games/Family,320x50,53.019702,25034,23764,24,0,0,0
USD,Android Top Selling Free Travel and Local,300x250,0.626001,185,170,1,1,1,0
USD,CST KPI List,970x250,1.098949,287,215,2,1,1,0
USD,DO NOT USE OAM FR,300x250,113.496963,14103,12869,4,47,0,47
USD,arizona opera top converters sx,320x50,156.185355,35732,34148,49,103,27,76
USD,mogo marks lal (purchase) platinum sx,336x280,1.647792,48,38,0,2,0,2
USD,mogo marks native (sharethrough) unique us sx,240x400,0.021704,1,1,0,0,0,0
USD,mogo marks native standard reach (no) tail aggregate sx,336x280,37.168972,3845,3404,0,11,0,11
USD,mogo marks perf arts sx 5 epx1,300x600,294.821864,23278,13571,31,90,21,69
USD,mogo marks philadelphia sx,320x50,55.122032,13699,12746,22,11,7,4
USD,Android Top Selling Free Game,160x600,3.211317,284,265,7,3,3,0
USD,Diablo Blacklist ,300x50,1.620314,991,966,0,8,0,8
USD,mogo marks lal branding (All) platinum sx,160x600,3595.716141,326352,244309,304,1884,101,1783
USD,mogo marks perf arts branding high reach sx,300x50,22.419197,3534,3357,1,44,0,44
USD,mogo marks toronto sx,300x50,0.013484,1,1,0,0,0,0
USD,ttd sports sx,200x200,0.032887,4,2,0,0,0,0
USD,Channel of Top Global Sites for Nielsen Video Ads - DO NOT EDIT,120x600,3.15417,828,677,0,0,0,0
USD,DO NOT USE Tier 3* (CHANNEL) (2),300x100,0.106198,16,15,0,0,0,0
USD,Lynn General,320x50,765.797119,273370,261511,141,211,62,149
USD,mogo marks detroit sx,970x250,15.292737,789,699,0,3,0,3
USD,Cal Perf KPI sx ,300x250,603.496224,146473,82575,140,15,0,15
USD,DO NOT USE Tier 3,300x250,33958.12084,7223154,5285634,3650,13970,1048,12922
USD,mogo centro sx US (2014),250x250,8.368209,848,765,0,1,0,1
USD,mogo marks lal (purchase) silver sx,160x600,28581.66898,6734876,6072176,2954,16780,1053,15727
USD,mogo marks native sx xsl1045 class b,320x100,3.391531,302,264,2,8,4,4
USD,ttd male sx,200x200,0.041891,5,2,0,0,0,0
USD,ttd shopping sx,300x250,3717.900344,330618,207366,155,1576,63,1513
USD,zt perf arts black sx 5,320x50,0.386938,191,168,0,1,0,1
USD,DO NOT USE OAM FR,970x250,0.002329,1,0,0,0,0,0
USD,DO NOT USE Tier 3 (2),970x90,8.387827,480,426,0,0,0,0
USD,DO_NOT_USE Bid Manager reportable sites channel (Soon to be deprecated and please exclude channel: Non-reportable sites and apps),300x50,3364.953929,634950,598782,409,9098,213,8885
USD,Performing Arts Fort Worth black sx,320x50,1.209329,303,182,0,0,0,0
USD,mogo marks branding drhbx gold sx,300x100,0.488874,80,71,0,0,0,0
USD,mogo marks branding tier 3 sx xls37852,300x250,32171.9293,4663006,3316161,3544,13568,1155,12413
USD,mogo marks native sx xsl1045 class c,300x50,420.341552,91108,86921,45,945,40,905
USD,ocfta local madison sx,300x250,30.95271,3416,3136,3,14,0,14
USD,provident shortlist ,250x250,36.24199,5394,4530,1,2,0,2
USD,ttd health wellness sx,336x280,1.002131,43,34,0,0,0,0
USD,/All Apps/Apple App Store/Games/Trivia,160x600,0.153439,6,6,1,0,0,0
USD,/All Apps/Apple App Store/Games/Word,300x250,219.551267,24934,23228,414,17,15,2
USD,Duxiana - Longtail Blacklist,320x50,195.241066,118045,108657,128,4,3,1
USD,LSSU url v1,970x250,13.140954,873,808,1,100,1,99
USD,dbm native sx (adx),160x600,1642.202332,278174,239613,112,617,21,596
USD,dbm video sx,300x50,596.269059,74930,71320,45,1673,25,1648
USD,mogo marks ballet sx,320x50,12.557555,1236,1022,1,2,0,2
USD,mogo marks lal branding (All) platinum sx,970x90,19.740338,838,726,3,2,0,2
USD,mogo marks los angeles sx,300x600,29.637668,2689,1752,12,9,2,7
USD,mogo marks perf arts sx 5 rx1,250x250,0.131271,18,13,0,0,0,0
USD,mogo marks video sx xsl44760 class b,970x66,0.020408,33,3,0,0,0,0
USD,mogo marks xsl_ks20780 sx,728x90,76139.32286,14989298,12060431,7430,40476,2448,38028
USD,ttd finance sx,300x50,51.772518,7307,6963,6,119,2,117
USD,ttd spanish sx,300x250,246.383126,83812,64124,84,74,20,54
USD,/All Apps/Google Play/Games/Word,300x50,19.677141,2113,2057,6,0,0,0
USD,/All Apps/Google Play/Health & Fitness,300x50,2.413983,493,451,0,0,0,0
USD,/All Apps/Google Play/Shopping,728x90,0.026942,29,29,0,0,0,0
USD,/All Apps/Google Play/Weather,320x100,0.534037,168,147,0,0,0,0
USD,Android Top Selling Free Books and Reference,728x90,2.557892,1218,1170,3,0,0,0
USD,Channel of Top Global Sites for Nielsen Video Ads - DO NOT EDIT,200x200,5.281519,499,365,0,1,0,1
USD,Mogo DBM basic video sx,200x200,0.218249,3,3,0,0,0,0
USD,SP News Black sx,320x50,97.630794,75887,64651,51,92,46,46
USD,mogo marks lal (purchase) silver sx,970x90,157.436432,9858,8409,12,16,0,16
USD,ttd shopping sx,970x250,44.306106,1456,1096,10,28,5,23
USD,Channel of Top US Sites for Nielsen Display Ads - DO NOT EDIT,250x250,127.027989,17183,14024,9,18,0,18
USD,DO NOT USE Tier 2,240x400,0.037469,3,3,0,0,0,0
USD,DO NOT USE Tier 3,970x250,1367.424978,327177,287715,331,559,148,411
USD,Lynn Undergrad,300x250,742.275712,228650,214220,76,288,53,235
USD,mogo marks broadwayworld sx,320x100,8.765242,445,292,0,4,0,4
USD,mogo marks nyc sx,300x600,666.750004,53474,41028,64,155,32,123
USD,mogo marks perf arts sx 7,728x90,804.65804,65988,45541,54,218,23,195
USD,ttd auto sx,200x200,0.017515,4,3,0,0,0,0
USD,Channel of Top US Sites for Nielsen Video Ads - DO NOT EDIT,300x50,2597.264719,588220,560326,256,6403,167,6236
USD,mogo marks branding max reach sx,336x280,230.742692,25867,22186,14,118,0,118
USD,mogo marks natl canada cat-aff-im sx,160x600,1190.526479,65859,45180,51,356,22,334
USD,mogo marks perf arts branding high reach sx,200x200,0.018275,2,1,0,0,0,0
USD,/All Apps/Apple App Store/Games/Family,300x600,14.821803,537,482,33,2,2,0
USD,/All Apps/Apple App Store/Games/Word,320x50,62.611115,28953,24161,104,11,1,10
USD,/All Apps/Apple App Store/Health & Fitness,300x50,3.057102,697,674,0,0,0,0
USD,/All Apps/Google Play/Entertainment,320x100,0.009163,20,18,0,0,0,0
USD,Mogo DBM premium video sx,970x250,6890.559127,848911,746199,1190,2422,462,1960
USD,arizona opera top converters sx,300x600,38.943022,4616,4353,2,9,2,7
USD,mogo marks bwwpb sx,300x50,0.216947,16,12,0,0,0,0
USD,mogo marks classical music sx,970x250,0.690328,101,49,0,0,0,0
USD,mogo marks houston sx,300x600,105.558708,13148,10234,13,14,1,13
USD,mogo marks kpi mdx sx xls9297,250x250,0.836191,72,60,0,0,0,0
USD,mogo mba tier 2 sx,970x90,15.572864,738,644,1,2,0,2
USD,ttd sports sx,120x600,0.58276,49,39,0,0,0,0
USD,/All Apps/Apple App Store/Utilities,300x250,11.925409,4776,4373,15,1,1,0
USD,/All Apps/Google Play/Games/Puzzle,160x600,0.545351,134,110,4,2,2,0
USD,Belmont Sitelist v1,160x600,565.998547,106814,104093,50,114,47,67
USD,DO NOT USE Tier 2,728x90,8434.820957,1419340,1190483,871,8443,336,8107
USD,PAC Singapore sx,320x50,84.865288,3778,3030,3,12,0,12
USD,mogo marks agg sx xsl37589,Unknown,5452.056295,162953,155927,839,110,0,110
USD,mogo marks branding comp rate gold video sx,728x90,20887.55765,4304925,3269420,2141,7869,637,7232
USD,mogo marks broadway sx,300x50,0.790071,51,45,0,4,0,4
USD,mogo marks perf arts sx 11,320x100,9.391924,525,347,1,4,0,4
USD,mogo marks video branding extended reach tail aggregate sx,160x600,20255.68734,6711166,5984100,2402,8348,668,7680
USD,mogo sf local sx,320x100,0.327348,37,32,0,0,0,0
USD,ttd beauty sx,970x90,0.788787,112,88,0,0,0,0
USD,ttd health sx,200x200,0.104045,7,4,0,0,0,0
USD,ttd sports sx,300x50,94.510291,21469,20267,18,88,6,82
USD,/All Apps/Apple App Store/Catalogs,300x600,0.139466,6,5,0,0,0,0
USD,Chicago T1 sites,728x90,54.305093,19868,15699,18,35,13,22
USD,mogo marks branding tier 3 sx xls37852,320x50,24638.1897,3423621,3152524,6671,11358,4031,7327
USD,mogo marks email sx,728x90,476.433054,200535,171796,64,94,12,82
USD,mogo marks philadelphia sx,300x600,2.121976,125,96,0,0,0,0
USD,mogo marks ttd obx kitchen premium sink sx,320x100,246.873607,50943,47180,86,148,28,120
USD,mogo marks wedding sx,336x280,0.05593,9,8,0,0,0,0
USD,ttd male sx,120x600,0.580979,38,31,0,0,0,0
USD,/All Apps/Apple App Store/Games/Educational,320x50,6.989791,8351,8158,11,0,0,0
USD,/All Apps/Google Play/Games/Action,728x90,0.14868,190,185,0,0,0,0
USD,Android Top Selling Free Entertainment,160x600,0.662755,97,87,0,0,0,0
USD,mogo biz-fi sx,300x50,43.437644,4821,4633,5,112,2,110
USD,mogo marks branding comp rate platinum video sx,200x200,0.12326,6,6,0,0,0,0
USD,mogo marks t1 brand kpi sx x8t,336x280,1.764767,71,57,0,1,0,1
USD,ttd travel sx,300x250,4306.503538,387282,255363,265,1820,122,1698
USD,/All Apps/Google Play/Games/Racing,970x250,0.074429,5,5,1,0,0,0
USD,DO NOT USE Microsoft Bin (001),250x250,8.905718,1212,905,0,1,0,1
USD,PAC Singapore sx,728x90,36.999341,1933,1482,5,6,0,6
USD,mogo centro sx US (2014),336x280,0.329469,49,44,0,0,0,0
USD,mogo marks branding comp rate silver video sx,468x60,1.450092,387,205,0,0,0,0
USD,mogo marks branding elite tier sx xls37852,320x51,0.8361,20,19,0,0,0,0
USD,mogo marks perf arts sx 6,320x100,9.419006,529,349,1,4,0,4
USD,zt perf arts black sx 5,300x600,0.009114,7,5,0,0,0,0
USD,mogo marks cincinnati sx,300x600,47.707581,5003,4259,5,11,2,9
USD,mogo marks classical music sx,300x250,20.660731,2386,1229,3,19,2,17
USD,mogo marks natl elite cat-aff-im sx,200x200,0.014553,1,0,0,0,0,0
USD,pac motorsports sx,300x50,191.135814,19589,18570,26,430,6,424
USD,ttd news sx,200x200,0.165799,9,9,0,0,0,0
USD,/All Apps/Apple App Store/Book,300x250,0.064417,31,27,0,0,0,0
USD,/All Apps/Google Play/Games/Board,336x280,0.001811,1,1,0,0,0,0
USD,DO NOT USE Rubicon,728x90,2059.864943,320796,165368,79,664,29,635
USD,fgu test public channel,250x250,0.970798,270,219,0,0,0,0
USD,mogo marks broadwayworld sx,320x50,72.886991,5934,3050,2,19,0,19
USD,mogo marks native sx xsl1045 class a,970x90,17.212011,2135,1737,0,3,0,3
USD,mogo marks sports sx,160x600,424.060125,62971,51266,23,74,1,73
USD,mogo marks video sx xsl44760 class b,320x100,7.592357,1697,1514,6,4,3,1
USD,mogo marks xsl_74205 (4p dims) sx ,250x250,13.627321,2336,1970,0,1,0,1
USD,/All Apps/Apple App Store/Music,320x100,0.076461,167,126,0,0,0,0
USD,Channel of Top Global Sites for Nielsen Display Ads - DO NOT EDIT,468x60,11.699614,5240,3511,1,3,0,3
USD,Chicago T1 sites,300x250,249.094502,93719,72112,89,148,54,94
USD,Mogo DBM premium video sx,300x250,56281.69735,10906713,8881038,6542,21222,1918,19304
USD,debartolo local site list,160x600,0.541768,53,37,0,2,0,2
USD,mogo CBS Interactive sx,970x250,77.840143,4042,3505,13,42,1,41
USD,mogo marks chicago sx,300x600,251.617621,32498,25680,17,39,7,32
USD,mogo marks xsl_ks0001 sx,300x50,1498.59605,264451,248643,147,4183,133,4050
USD,/All Apps/Google Play/Games/Racing,300x250,4.4342,391,364,5,0,0,0
USD,AC black sx,300x250,0.014404,1,1,0,0,0,0
USD,mogo jacks education sx,320x50,0.050901,16,9,0,0,0,0
USD,mogo marks branding comp rate platinum video sx,120x600,0.006865,4,4,0,0,0,0
USD,mogo marks pav kpi sx,728x90,1094.532532,105907,79934,69,491,37,454
USD,mogo marks perf arts sx 2,300x50,19.003047,2463,2302,4,44,2,42
USD,mogo marks ticketing sx,300x50,0.144099,7,7,0,0,0,0
USD,/All Apps/Google Play/Weather,320x50,2207.311864,741148,684386,626,134,71,63
USD,mogo marks elite kpi achievers sx,970x250,3856.317851,262719,215298,486,1158,261,897
USD,ttd food sx,300x50,196.605929,20251,19255,16,726,30,696
USD,ttd health sx,120x600,0.117174,16,10,0,0,0,0
USD,/All Apps/Apple App Store/Sports,970x250,0.020269,1,1,0,0,0,0
USD,/All Apps/Google Play/Books & Reference,970x250,0.009217,8,8,0,0,0,0
USD,/All Apps/Google Play/Games/Casual,320x50,80.372678,77443,75578,114,16,12,4
USD,Android Top Selling Free Entertainment,336x280,0.019472,9,9,0,0,0,0
USD,DO NOT USE Tier 2,468x60,1.430465,645,311,0,0,0,0
USD,mogo marks natl cat-aff-im sx,200x200,0.137813,7,6,0,0,0,0
USD,mogo marks xsl_ks20780 sx,970x66,1.217537,576,161,0,0,0,0
USD,mogo sports sx,300x100,0.050601,12,10,0,0,0,0
USD,/All Apps/Google Play,728x90,213.761399,139828,134514,181,16,15,1
USD,DO NOT USE Tier 3 (2),320x50,2145.245955,653955,603383,707,936,217,719
USD,mogo marks lal branding (All) platinum sx,320x50,12700.89388,1180417,1067034,4162,6007,3197,2810
USD,mogo marks perf arts sx 5 epx1,970x66,0.004991,1,0,0,0,0,0
USD,mogo marks video branding extended reach tail aggregate sx,336x280,39.93427,7600,6648,7,7,0,7
USD,sfoc kpi sx (acquisition 2019),728x90,199.031623,37133,34126,33,317,24,293
USD,/All Apps/Apple App Store/Music,300x50,2.166488,860,810,3,0,0,0
USD,Android Movers and Shakers,320x50,512.020223,284199,272833,1109,149,120,29
USD,DO NOT USE Tier 2* (CHANNEL),970x90,34.434362,3188,2791,4,9,0,9
USD,at black perf arts sx 7,320x50,1.633831,348,305,1,0,0,0
USD,mogo marks branding comp rate gold video sx,468x60,0.027797,13,11,0,0,0,0
USD,mogo marks native sx xsl1045 class a,970x250,549.947554,312766,295644,346,258,35,223
USD,mogo marks t1 brand sx trim,970x90,81.520315,6164,5243,9,5,0,5
USD,/All Apps/Apple App Store/Games/Action,300x50,0.634742,60,48,0,0,0,0
USD,/All Apps/Apple App Store/Games/Role Playing,320x50,1.792067,1386,1362,2,0,0,0
USD,/All Apps/Google Play/Personalization,320x50,2.562586,2447,2234,9,0,0,0
USD,Android Top Selling Free Photography,320x50,31.926769,36570,34725,80,3,3,0
USD,Channel of Top Global Sites for Nielsen Video Ads - DO NOT EDIT,970x90,205.718451,17894,15399,13,17,0,17
USD,Diablo DVC Shortlist (Advertiser Level),728x90,1238.842202,93350,88659,41,9827,93,9734
USD,Walnut Street Theatre - In-Stream Video Blacklist,728x90,0.190569,28,23,0,0,0,0
USD,mogo black rt sx,728x90,9.451042,1909,1615,1,4,0,4
USD,mogo marks branding drhbx gold sx,250x250,10.081787,940,776,0,5,0,5
USD,mogo marks branding drhbx platinum sx,336x280,3.256606,208,175,0,0,0,0
USD,mogo marks disney sx,200x200,0.001435,2,0,0,0,0,0
USD,mogo marks playbill 5 sx x9z,300x600,0.968013,122,36,0,1,0,1
USD,mogo marks xsl_800p sx,728x90,64704.7214,12712758,10190364,6059,34263,1958,32305
USD,/All Apps/Google Play/Games/Puzzle,336x280,0.053417,18,13,0,0,0,0
USD,/All Apps/Google Play/Games/Word,160x600,1.515702,361,334,0,0,0,0
USD,DO NOT USE Tier 1* (CHANNEL),250x250,32.022765,3717,3064,2,5,0,5
USD,Pac Fox Atlanta EXCLUSION List,320x50,486.75076,216699,205943,134,166,32,134
USD,mogo marks chicago sx,160x600,112.129092,29700,25665,31,52,15,37
USD,mogo marks lal (purchase) silver sx,320x50,51000.00436,9347330,8676786,13495,22525,5983,16542
USD,mogo marks lal branding (All) gold sx,320x51,0.8361,20,19,0,0,0,0
USD,/All Apps/Google Play/Media & Video,300x250,1.859094,663,597,1,0,0,0
USD,Channel of Top non-US Sites for Nielsen Video Ads - DO NOT EDIT,160x600,15371.24545,4186326,3739082,1733,6633,472,6161
USD,DO NOT USE Mobile - MoPub - Computers & Electronics/Consumer Electronics/GPS & Navigation,300x50,0.02392,5,5,0,0,0,0
USD,DO NOT USE Rubicon,320x50,1114.233898,115526,106376,196,358,68,290
USD,DO NOT USE Tier 3 (2),336x280,14.431609,1231,1084,0,7,0,7
USD,DO NOT USE fgu test public channel,970x66,0.508369,179,117,0,0,0,0
USD,mogo marks pav kpi sx,320x50,1880.925455,137656,120337,365,945,119,826
USD,mogo marks perf arts sx 11,300x250,3088.255301,183241,124013,283,1252,128,1124
USD,mogo marks shakespeare sx,728x90,89.421779,6998,5738,6,13,1,12
USD,mogo marks ttd obx kitchen premium sink sx,300x250,129205.8017,26325989,20715148,13531,47042,4116,42926
USD,mogo marks xsl_ks0001 sx,120x600,2.766699,658,338,0,0,0,0
USD,sfoc stratford hqcat sx,728x90,112.642929,15504,14253,17,176,12,164
USD,ttd kids sx,320x50,1082.417104,629821,591633,505,470,123,347
USD,/All Apps/Google Play/Games/Casual,336x280,0.015094,4,4,1,0,0,0
USD,/All Apps/Google Play/Games/Racing,300x600,1.60477,186,174,5,0,0,0
USD,Android Top Selling Free News and Magazines,320x100,0.000058,1,1,0,0,0,0
USD,Android Top Selling Free Photography,336x280,0.001179,1,1,0,0,0,0
USD,mogo marks branding tier 1 sx xls37852,120x600,4.484801,696,545,0,0,0,0
USD,mogo marks kpi achievers sx,970x66,0.004991,1,0,0,0,0,0
USD,mogo sf local sx,300x250,1983.941227,418478,211886,212,734,112,622
USD,/All Apps/Apple App Store/Games/Arcade,300x50,0.004801,2,2,0,0,0,0
USD,Android Movers and Shakers,336x280,0.0046,2,1,0,0,0,0
USD,DCPA rt black sx,970x250,3.325426,80,65,1,1,1,0
USD,DO NOT USE Invite US Expandable Enabled Sites,970x90,6.259254,1205,1094,2,2,0,2
USD,Duxiana- Bad Site List(Allan) ,728x90,26.958973,20222,18042,7,0,0,0
USD,Pac Fox Atlanta EXCLUSION List,336x280,0.05761,25,23,0,0,0,0
USD,mogo marks bw-theatre sx,160x600,13.87757,2048,933,1,21,0,21
USD,mogo marks lal branding (All) platinum sx,336x280,6.155034,310,275,0,8,0,8
USD,provident shortlist ,300x100,0.379002,75,67,0,0,0,0
USD,ttd sports sx,468x60,0.209171,68,60,0,0,0,0
USD,/All Apps/Apple App Store/Business,728x90,201.6909,48835,43768,62,3,0,3
USD,Chicago T1 sites,300x600,25.503441,6022,4781,11,13,5,8
USD,DO NOT USE Invite December Brand Safe List,320x50,49354.32502,11951724,11085200,15356,20066,6308,13758
USD,DSM African American sx,728x90,0.842775,88,80,0,0,0,0
USD,Duxiana Broadcast blacklist,160x600,0.002501,7,7,0,0,0,0
USD,mogo marks classical music sx,300x600,19.946545,2130,1317,1,4,0,4
USD,mogo marks lal (purchase) silver sx,336x280,26.477167,2212,1920,0,16,0,16
USD,mogo marks native (sharethrough) unique us sx,728x90,12501.35291,2475656,2163583,978,6800,318,6482
USD,mogo marks natl cat-aff-im sx 3,250x250,1.273695,116,106,0,0,0,0
USD,mogo marks perf arts sx 6,300x250,3303.815017,205780,142017,303,1306,135,1171
USD,/All Apps/Apple App Store/Book,300x600,0.732179,33,22,0,0,0,0
USD,mogo education sx,970x90,10.016853,1053,989,2,3,0,3
USD,mogo marks high intenders sx,320x100,28.4181,13284,12263,13,40,4,36
USD,mogo marks video sx xsl44760 class b,970x250,1450.937124,387912,358932,455,539,120,419
USD,ttd finance sx,970x66,0.01929,4,1,0,0,0,0
USD,Android Top Selling Free Music and Audio,300x600,42.23598,2139,1893,54,12,11,1
USD,Channel of Top non-US Sites for Nielsen Video Ads - DO NOT EDIT,728x90,33463.55864,7153091,5933354,3357,14377,811,13566
USD,DO NOT USE Tier 2* (CHANNEL),240x400,0.037469,3,3,0,0,0,0
USD,mogo marks kpi achievers sx,336x280,2.242297,228,191,0,1,0,1
USD,mogo marks playbill sx x3e,160x600,66.514515,3547,3120,8,24,1,23
USD,mogo sports sx,970x90,79.118462,5482,4602,0,2,0,2
USD,ttd male sx,600x250,0.000272,1,0,0,0,0,0
USD,Belmont Sitelist v1,300x600,826.998629,90562,84862,216,448,180,268
USD,DO NOT USE Tier 1,300x250,80296.77336,15031527,11964228,9177,31358,2893,28465
USD,DO NOT USE Tier 3,250x250,28.513369,3416,2774,0,7,0,7
USD,Western Black sx,300x600,142.478768,23649,21716,7,554,4,550
USD,mogo marks branding comp rate gold video sx,970x66,0.088157,47,9,0,0,0,0
USD,ttd gaming sx,120x600,0.324049,141,107,0,0,0,0
USD,/All Apps/Google Play/Social,320x100,0.011328,14,11,0,0,0,0
USD,/All Apps/Google Play/Tools,300x50,8.663587,1250,1171,3,0,0,0
USD,DO NOT USE Tier 3 (2),468x60,0.529298,233,147,0,0,0,0
USD,Duxiana Broadcast blacklist,320x50,0.431365,481,439,1,0,0,0
USD,mogo marks lal (purchase) platinum sx,970x66,0.004991,1,0,0,0,0,0
USD,mogo marks natl cat-aff-im sx 3,300x600,3506.492333,322872,283695,311,1485,151,1334
USD,mogo marks sports sx,320x50,4598.428598,936728,850423,717,856,132,724
USD,BBB perf arts 5 black sx,728x90,0.728873,53,48,0,0,0,0
USD,DO NOT USE Mobile - MoPub - Games/Computer & Video Games/Music & Dance Games,728x90,16.245648,27832,27717,4,0,0,0
USD,mogo marks bw-theatre sx,728x90,0.029181,7,3,0,0,0,0
USD,ttd shopping sx,250x250,2.002656,129,116,1,1,0,1
USD,/All Apps/Apple App Store/Shopping,728x90,1.332335,767,712,0,0,0,0
USD,/All Apps/Google Play/Games/Trivia,300x50,2.423798,1104,1034,1,0,0,0
USD,BBB perf arts 5 black sx,320x50,71.401649,10989,10574,8,44,3,41
USD,DO NOT USE OAM FR,250x250,0.011688,4,4,0,0,0,0
USD,mogo marks branding max reach sx,320x51,0.837271,21,20,0,0,0,0
USD,mogo marks lal branding (All) gold sx,970x250,6508.305721,434508,361781,863,2233,400,1833
USD,mogo marks perf arts silver sx,320x50,2444.046344,408453,368294,343,1322,135,1187
USD,mogo marks perf arts silver sx,728x90,1601.384173,169492,131248,70,622,29,593
USD,mogo marks xsl_74205 sx ,336x280,13.616111,995,911,0,3,0,3
USD,ttd family parent sx,200x200,0.148017,10,10,0,1,0,1
USD,ttd sports sx,600x250,0.000272,1,0,0,0,0,0
USD,mogo marks expedia sx,300x250,4.519687,390,10,0,8,0,8
USD,mogo marks native sx xsl1045 class b,300x600,3477.828644,426227,360961,336,1359,88,1271
USD,mogo marks natl canada cat-aff-im sx,200x200,0.014553,1,0,0,0,0,0
USD,mogo marks perf arts silver sx,970x66,0.004991,1,0,0,0,0,0
USD,mogo marks perf arts sx 6,320x50,1474.152637,110841,99753,170,882,77,805
USD,mogo marks ttd obx kitchen premium sink sx,320x50,78138.67855,20180728,18517073,22520,31510,8687,22823
USD,mogo marks xsl_800p sx,250x250,74.676117,9448,7803,3,11,0,11
USD,ttd education sx,970x250,281.384088,15660,12295,92,77,6,71
USD,/All Apps/Google Play/Education,300x50,1.017081,504,484,1,0,0,0
USD,/All Apps/Google Play/Finance,300x50,0.440622,125,119,0,1,0,1
USD,/All Apps/Google Play/Media & Video,320x50,10.741501,15848,15142,30,6,4,2
USD,Channel of Top Global Sites for Nielsen Video Ads - DO NOT EDIT,Unknown,5452.056295,162953,155927,839,110,0,110
USD,cmt perf arts black sx 7,300x250,0.000838,1,1,0,0,0,0
USD,mogo marks natl cat-aff-im sx,300x250,30099.56311,4235588,3245655,3612,10558,1181,9377
USD,mogo marks perf arts platinum sx,300x600,229.334939,17459,9507,22,74,16,58
USD,mogo marks sacramento sx,160x600,5.414743,399,334,0,1,0,1
USD,mogo t1 brand sx,728x90,19321.60021,3238232,2334072,2171,6842,483,6359
USD,/All Apps/Google Play,250x250,0.005227,1,1,0,0,0,0
USD,mogo marks natl elite cat-aff-im sx,300x100,0.153683,27,20,0,0,0,0
USD,mogo marks nyt sx,970x250,3522.006276,244183,202857,429,948,184,764
USD,mogo marks t1 brand sx trim,468x60,0.526249,258,178,0,0,0,0
USD,mogo marks ttd obx kitchen premium sink sx,728x90,59121.78202,11541304,9132164,5657,25404,1641,23763
USD,mogo marks video sx xsl44760 class c,300x250,82477.33427,17940018,14752275,9036,30729,2755,27974
USD,/All Apps/Google Play/Communication,300x250,802.616299,93468,83410,1235,550,490,60
USD,Stratford KPI sx,300x250,79.19497,8046,7289,3,101,6,95
USD,mogo marks branding tier 2 sx xls37852,970x90,156.162634,12343,10628,14,17,1,16
USD,mogo marks perf arts sx 11,320x50,1258.397953,89990,80826,153,731,69,662
USD,mogo marks playbill sx x3e,300x600,0.968013,122,36,0,1,0,1
USD,mogo marks san francisco sx,300x250,1659.636102,290974,166532,156,599,81,518
USD,mogo sf local sx,320x50,2292.117431,389892,354334,611,710,232,478
USD,ttd weather sx,300x50,9.115665,1085,1038,3,50,3,47
USD,Android Top Selling Free Tools,300x50,0.331912,80,76,0,0,0,0
USD,mogo marks agg sx xsl37589,320x51,0.837271,21,20,0,0,0,0
USD,mogo marks branding elite tier sx xls37852,300x250,9278.017905,1214434,951528,1342,3355,438,2917
USD,mogo marks hq100p sx,970x90,64.240927,5028,4264,7,8,0,8
USD,mogo marks native (sharethrough) unique can sx,120x600,0.023903,4,2,0,0,0,0
USD,mogo marks native high reach tail aggregate sx,300x250,96851.83255,19431576,15031535,11302,38908,3305,35603
USD,mogo marks perf arts gold sx,300x250,3816.056725,238608,168523,327,1546,147,1399
USD,mogo marks video branding medium reach tail aggregate sx,320x51,0.837271,21,20,0,0,0,0
USD,/All Apps/Apple App Store/Games/Word,300x50,5.640534,199,178,1,0,0,0
USD,/All Apps/Google Play/Social,300x250,143.277261,49225,41098,107,21,16,5
USD,ttd spanish sx,300x50,12.344274,2871,2675,0,18,0,18
USD,DO NOT USE Invite December Brand Safe List,970x66,0.624807,324,39,0,0,0,0
USD,Provident High CTR List ,970x250,30.428775,1375,1291,2,0,0,0
USD,RCU Blacklist Sites (CPA),320x50,0.12455,18,17,0,0,0,0
USD,mogo marks native (sharethrough) unique us sx,970x66,0.058052,196,3,0,0,0,0
USD,mogo marks perf arts platinum sx,250x250,0.120817,17,12,0,0,0,0
USD,mogo marks t1 brand kpi sx x8t,320x100,14.379168,1992,1666,6,8,3,5
USD,/All Apps/Apple App Store/Games/Educational,300x50,0.056491,29,28,0,0,0,0
USD,at atlanta sx,300x600,3.432542,364,325,0,1,0,1
USD,mogo marks broadway sx,250x250,0.019762,6,1,0,0,0,0
USD,mogo marks t1 brand sx trim,336x280,13.578731,1507,1338,0,1,0,1
USD,mogo marks travel sx,320x50,1015.358927,94832,87644,125,384,24,360
USD,mogo marks xsl_ks0001 sx,600x250,0.000272,1,0,0,0,0,0
USD,mogo marks xsl_ks20780 sx,200x200,4.505037,477,366,0,2,0,2
USD,ttd spanish sx,120x600,0.02779,49,36,0,0,0,0
USD,/All Apps/Apple App Store/Newsstand,728x90,329.543612,158418,136163,81,3,1,2
USD,/All Apps/Apple App Store/Reference,320x100,0.720124,350,276,0,0,0,0
USD,mogo black sx,970x250,91.072498,7134,5835,14,16,6,10
USD,mogo centro sx US (2014),320x100,28.335752,6515,5960,29,20,7,13
USD,mogo marks branding tier 2 sx xls37852,120x600,2.151582,283,229,0,0,0,0
USD,mogo marks branding tier 3 sx xls37852,300x50,539.252098,59437,56139,36,1712,40,1672
USD,mogo marks dallas sx,970x250,2.985984,159,129,0,0,0,0
USD,mogo marks native sx xsl1045 class b,250x250,10.49775,1376,1034,2,1,0,1
USD,mogo marks wine sx,970x90,0.318228,21,14,0,0,0,0
USD,mogo marks hq100p sx,120x600,0.498775,50,40,0,0,0,0
USD,mogo marks perf arts sx 6,160x600,1639.55136,97908,71424,75,550,31,519
USD,mogo marks perf arts sx 7,200x200,0.014553,1,0,0,0,0,0
USD,mogo marks ttd obx kitchen premium sink sx,160x600,28322.99855,7175825,6350307,3144,11031,992,10039
USD,pac motorsports sx,728x90,4341.791947,538179,388460,222,1023,48,975
USD,/All Apps/Google Play/Libraries & Demo,320x50,0.018621,10,8,0,0,0,0
USD,/All Apps/Google Play/Sports,160x600,0.004284,1,1,0,0,0,0
USD,mogo CBS Interactive sx,970x66,0.23555,47,9,0,0,0,0
USD,mogo marks nyc sx,300x250,7181.713369,1044533,811415,1197,2175,379,1796
USD,mogo marks perf arts sx 2,160x600,1846.187976,119891,87489,86,598,35,563
USD,sfoc marks kpi sx (062018),300x600,177.34679,12113,11065,17,269,21,248
USD,ttd education sx,468x60,0.347125,116,80,0,0,0,0
USD,Android Top Selling Free Travel and Local,320x100,0.00483,14,13,0,0,0,0
USD,DO NOT USE,300x250,3.964091,113,108,1,0,0,0
USD,DO NOT USE OAM FR,320x100,0.00115,1,0,0,4,0,4
USD,Performing Arts Fort Worth black sx,728x90,0.020844,5,4,0,0,0,0
USD,Stratford Black RT SX,300x600,1.633644,212,186,0,0,0,0
USD,mogo marks branding comp rate silver video sx,200x200,2.333869,163,108,0,1,0,1
USD,mogo marks branding drhbx silver sx,200x200,1.238134,129,73,0,2,0,2
USD,mogo marks pav kpi hx,160x600,1309.519531,298351,252125,121,441,34,407
USD,zt local austin sx,300x600,3.271598,348,284,2,1,0,1
USD,/All Apps,300x50,337.775765,66953,63432,145,27,5,22
USD,/All Apps/Google Play/Lifestyle,320x50,62.383278,31634,30094,71,11,6,5
USD,DO NOT USE Mobile - MoPub - Arts & Entertainment,300x50,0.789918,346,342,0,0,0,0
USD,DO NOT USE Tier 3,320x100,209.88498,33510,31488,49,110,15,95
USD,DO NOT USE Tier 3* (CHANNEL) (2),300x50,62.015719,11579,10804,3,146,4,142
USD,mogo marks native medium reach tail aggregate sx,200x200,1.437393,103,85,0,1,0,1
USD,mogo marks video sx xsl44760 class a,728x90,1310.992291,412105,262284,857,599,58,541
USD,pac motorsports sx,160x600,25.576373,5090,4341,3,3,0,3
USD,ttd female sx,300x100,0.083267,9,1,0,0,0,0
USD,ttd shopping sx,320x100,2.490776,257,211,0,3,0,3
USD,Duxiana - Longtail Blacklist,728x90,37.079809,31910,29357,21,1,0,1
USD,mogo marks ballet sx,728x90,31.865554,5464,3918,5,13,3,10
USD,mogo marks high intenders sx,300x600,1353.781855,103108,88141,125,635,68,567
USD,mogo marks lal (purchase) gold sx,336x280,17.578606,1373,1234,0,10,0,10
USD,pac canada sports sx,320x100,4.158211,432,400,2,9,0,9
USD,sfoc 2018 marks stratford premium sx,300x250,1695.198502,382427,351623,218,2697,192,2505
USD,ttd food sx,160x600,491.630144,45758,39606,25,292,5,287
USD,/All Apps/Apple App Store/Games/Action,300x600,2.873515,223,159,10,0,0,0
USD,/All Apps/Apple App Store/Games/Card,320x50,106.282691,75344,72523,164,3,3,0
USD,Android Top Selling Free News and Magazines,300x600,99.489003,3979,3887,22,8,3,5
USD,DO NOT USE Tier 1,200x200,0.534743,76,32,0,1,0,1
USD,DO NOT USE fgu test public channel,300x50,0.006124,3,2,0,0,0,0
USD,Portland Center Stage Perf Arts 5 black sx,300x600,0.119455,11,10,1,0,0,0
USD,SP News Black sx,728x90,82.426161,15734,13237,12,87,9,78
USD,gostanford.com,970x90,0.041589,1,1,0,0,0,0
USD,mogo marks los angeles sx,300x250,342.583919,62703,49386,43,52,10,42
USD,mogo marks wedding sx,160x600,1.438068,129,89,0,1,0,1
USD,mogo marks branding tier 2 sx xls37852,160x600,10598.6872,1842274,1660133,1022,4606,284,4322
USD,mogo marks perf arts sx 2,300x600,491.188872,44114,28758,47,161,30,131
USD,mogo marks perf arts sx 5 rx1,468x60,0.011632,4,2,0,0,0,0
USD,mogo marks playbill 5 sx x9z,300x50,0.008855,11,9,0,0,0,0
USD,/All Apps/Google Play/Games/Casual,970x250,0.00667,2,2,0,0,0,0
USD,/All Apps/Google Play/Games/Music,320x50,4.617849,2084,1991,16,0,0,0
USD,/All Apps/Google Play/Travel & Local,300x250,7.444909,760,541,2,4,2,2
USD,Mogo DBM select video sx,160x600,397.315971,52111,46037,26,175,3,172
USD,dbm native sx (adx),300x250,34336.43169,7404122,6163209,3698,10349,1006,9343
USD,mogo marks branding comp rate gold video sx,300x100,0.003136,1,1,0,0,0,0
USD,mogo marks branding drhbx gold sx,320x51,0.8361,20,19,0,0,0,0
USD,mogo marks perf arts sx 5 epx1,970x90,1.35234,118,101,0,2,0,2
USD,ttd entertainment sx,120x600,0.021752,3,2,0,0,0,0
USD,ttd gaming sx,250x250,4.263734,407,333,0,2,0,2
USD,/All Apps/Apple App Store,250x250,0.007318,1,1,0,0,0,0
USD,/All Apps/Apple App Store/Education,300x250,0.185512,101,76,2,0,0,0
USD,DO NOT USE Tier 3* (CHANNEL),120x600,5.586385,1298,923,1,0,0,0
USD,Performing Arts Fort Worth Perf Arts 5 black sx,160x600,0.09516,22,20,0,0,0,0
USD,finn dallas native sx,320x50,1567.230549,165493,151537,288,922,125,797
USD,magic theatre top performing sx,728x90,22.080463,6485,3500,1,10,1,9
USD,mogo education sx,970x66,0.013239,5,2,0,0,0,0
USD,mogo marks disney sx,336x280,0.336577,38,28,0,0,0,0
USD,t1 brand black sx,320x50,0.825358,105,95,0,0,0,0
USD,ttd shopping sx,970x90,25.455934,1188,1024,3,0,0,0
USD,/All Apps/Google Play/Productivity,160x600,0.014461,3,2,0,0,0,0
USD,Channel of Top US Sites for Nielsen Display Ads - DO NOT EDIT,468x60,17.010941,6870,4656,1,4,0,4
USD,Channel of Top non-US Sites for Nielsen Video Ads - DO NOT EDIT,320x51,0.837271,21,20,0,0,0,0
USD,DO NOT USE Tier 3 (2),200x200,1.553116,44,29,0,0,0,0
USD,mogo financial services kpi sx,336x280,0.886246,21,20,0,0,0,0
USD,mogo marks hq100p sx,160x600,16024.88407,3576818,3162905,1586,4894,569,4325
USD,mogo marks lal (purchase) silver sx,970x250,9228.97329,993061,866263,1600,3462,645,2817
USD,mogo marks natl canada cat-aff-im sx,300x250,13261.25599,1833200,1465510,1907,5469,687,4782
USD,mogo marks video branding max reach tail aggregate sx,320x100,335.926495,55694,51615,96,171,26,145
USD,mogo marks wine sx,728x90,125.818408,15676,13129,3,74,3,71
USD,/All Apps/Apple App Store/Games/Arcade,300x600,1.272991,98,83,4,0,0,0
USD,/All Apps/Apple App Store/Photo & Video,300x250,4.396812,2022,1844,2,0,0,0
USD,Channel of Top Global Sites for Nielsen Display Ads - DO NOT EDIT,240x400,0.229141,21,13,0,0,0,0
USD,Seattle Local sx,728x90,16.961959,8456,7308,4,1,0,1
USD,mogo marks denver sx,200x200,0.017062,3,3,0,0,0,0
USD,mogo marks natl cat-aff-im sx,336x280,11.769526,877,798,0,2,0,2
USD,mogo marks perf arts gold sx,336x280,0.888875,35,27,0,2,0,2
USD,ttd food sx,300x600,2140.842918,164287,149270,158,1117,56,1061
USD,/All Apps/Apple App Store/Newsstand/Regional News,300x250,666.866091,235630,199637,260,12,5,7
USD,DO NOT USE Tier 1* (CHANNEL),120x600,2.887532,540,446,0,0,0,0
USD,DO NOT USE Tier 3* (CHANNEL) (2),200x200,1.553116,44,29,0,0,0,0
USD,Lynn Undergrad,728x90,228.673709,81511,76389,30,124,18,106
USD,mogo marks nyc sx,320x50,4203.983984,676017,636596,2202,939,551,388
USD,mogo marks xsl_74205 sx ,970x250,5464.590162,729549,644977,1005,2089,443,1646
USD,/All Apps/Google Play/Business,300x250,4.127825,387,332,1,0,0,0
USD,DO NOT USE Invite US Expandable Enabled Sites,336x280,0.844569,253,198,0,0,0,0
USD,dbm video sx,200x200,0.282192,18,18,0,1,0,1
USD,maryland-dc sx,300x250,553.005393,180186,142206,153,83,58,25
USD,mogo marks branding drhbx gold sx,120x600,1.459994,125,101,0,0,0,0
USD,mogo marks branding max reach sx,250x250,105.47445,13535,11110,5,20,0,20
USD,mogo marks perf arts silver sx,300x50,14.98486,2733,2639,1,24,0,24
USD,ttd weather sx,160x600,26.085096,3552,2989,1,8,0,8
USD,DO NOT USE,320x50,3.279294,146,140,1,0,0,0
USD,Top Performing Sites,160x600,1530.153493,624629,524584,161,176,37,139
USD,mogo marks kpi achievers sx,970x250,4257.796636,281671,230123,551,1263,270,993
USD,mogo marks native sx xsl1045 class c,200x200,0.747445,47,39,0,0,0,0
USD,mogo marks perf arts sx 5 rx1,160x600,1848.609775,118904,85872,86,607,34,573
USD,mogo marks xsl_ks0001 sx,970x66,1.146605,504,156,0,0,0,0
USD,ocfta local madison sx,728x90,56.603572,3201,2994,2,29,0,29
USD,sfoc pslx 2018 sx (Jun_2018),300x600,1378.673499,231345,215046,229,1796,201,1595
USD,ttd health wellness sx,250x250,6.080917,533,424,0,1,0,1
USD,/All Apps/Google Play/Finance,160x600,0.003306,4,4,0,0,0,0
USD,/All Apps/Google Play/Games/Adventure,300x600,0.193373,28,27,0,0,0,0
USD,Channel of Top non-US Sites for Nielsen Video Ads - DO NOT EDIT,300x50,1010.27713,236210,225011,109,2518,77,2441
USD,DO NOT USE Spanish Language Sites,970x250,0.864847,145,121,0,0,0,0
USD,Fan Extender IMG/Sidearm Blacklist,970x90,0.046335,3,3,0,0,0,0
USD,mogo cult soph sx,970x90,38.702353,3210,2787,5,6,1,5
USD,mogo education sx,336x280,1.05197,221,194,0,0,0,0
USD,mogo marks los angeles sx,320x50,309.158854,74371,66749,106,85,35,50
USD,mogo marks pav kpi sx 2,160x600,2869.364256,315576,261267,134,804,42,762
USD,nancy sitelist (Advertiser Level),300x250,8.244034,115,106,0,0,0,0
USD,sfoc pslx 2019 sx (Mar_2019),160x600,526.883325,188666,175261,125,567,78,489
USD,ttd spanish sx,728x90,338.227052,171772,153623,43,162,19,143
USD,Channel of Top US Sites for Nielsen Display Ads - DO NOT EDIT,900x90,0.015264,14,8,0,0,0,0
USD,mogo marks chicago sx,320x100,1.936053,522,485,0,0,0,0
USD,mogo music sx,336x280,0.057682,5,4,0,0,0,0
USD,/All Apps/Apple App Store/Newsstand/Regional News,300x600,104.242455,22038,16700,68,1,0,1
USD,Channel of Top US Sites for Nielsen Video Ads - DO NOT EDIT,200x200,5.647436,537,387,0,1,0,1
USD,Channel of Top non-US Sites for Nielsen Display Ads - DO NOT EDIT,160x600,29458.20309,7401047,6554824,3497,16540,1089,15451
USD,DO NOT USE Tier 1,300x100,1.8676,390,341,1,0,0,0
USD,mogo marks natl cat-aff-im sx 2,468x60,0.006997,3,1,0,0,0,0
USD,ocfta local madison sx,320x50,21.391222,2738,2618,5,31,0,31
USD,ttd male sx,300x50,101.411671,30452,28985,8,202,8,194
USD,/All Apps/Apple App Store/Book,320x100,0.001679,7,7,0,0,0,0
USD,/All Apps/Apple App Store/Games/Educational,728x90,7.907262,3184,3129,15,3,3,0
USD,DO NOT USE Mobile - MoPub - Games/Computer & Video Games/Music & Dance Games,300x50,0.01878,12,12,0,0,0,0
USD,Lynn Undergrad,320x50,394.833404,207649,199165,67,88,25,63
USD,arizona opera top converters sx,300x250,221.208121,47316,44278,26,76,24,52
USD,mogo lydia peacecenter test,160x600,15468.24588,3914409,3486869,1726,4957,580,4377
USD,mogo marks agg sx xsl37589,468x60,13.667701,4545,3152,0,2,0,2
USD,mogo marks branding drhbx platinum sx,468x60,0.15476,59,55,0,0,0,0
USD,mogo marks branding tier 1 sx xls37852,970x66,0.846179,280,149,0,0,0,0
USD,mogo marks chicago sx,970x250,81.683951,9107,7206,9,33,1,32
USD,mogo marks houston sx,300x250,415.895865,79634,63766,57,78,4,74
USD,mogo marks natl cat-aff-im sx 3,300x100,0.153683,27,20,0,0,0,0
USD,mogo marks pav kpi hx,336x280,0.242653,28,22,0,1,0,1
USD,mogo marks video branding medium reach tail aggregate sx,468x60,6.00143,1634,1129,0,0,0,0
USD,mogo marks xsl_74205 (4p dims) sx ,160x600,4397.513482,1027945,913436,410,1838,111,1727
USD,/All Apps/Apple App Store/Shopping,300x50,0.12443,22,21,0,0,0,0
USD,/All Apps/Google Play/Business,300x600,0.633998,29,26,0,0,0,0
USD,DO_NOT_USE Bid Manager reportable sites channel (Soon to be deprecated and please exclude channel: Non-reportable sites and apps),200x200,5.321208,693,529,0,2,0,2
USD,Lynn General,300x250,1272.495221,274753,257556,103,675,70,605
USD,mogo black sx,336x280,2.195217,938,827,0,1,0,1
USD,mogo marks branding tier 3 sx xls37852,728x90,16699.09426,2134548,1458888,1106,6866,358,6508
USD,nancy sitelist (Advertiser Level),300x600,11.730886,179,165,0,0,0,0
USD,ttd entertainment sx,970x90,42.111373,4454,3865,4,6,0,6
USD,ttd music sx,468x60,0.032221,36,31,0,0,0,0
USD,/All Apps/Apple App Store/Games/Family,300x250,1.352977,102,84,1,0,0,0
USD,/All Apps/Apple App Store/Games/Word,728x90,115.350016,42755,41427,155,6,6,0
USD,Mogo DBM premium video sx,320x100,18.701282,4903,4389,24,25,7,18
USD,fgu test public channel,160x600,139.19825,21393,10431,9,52,2,50
USD,kid safe sx,468x60,0.189609,100,70,0,0,0,0
USD,mogo marks philadelphia sx,300x250,39.024357,3927,2849,4,11,3,8
USD,Android Top Selling Free Tools,160x600,0.575453,84,76,0,0,0,0
USD,Mercury Theater Chicago sx,160x600,111.245696,20171,17848,18,23,14,9
USD,maryland-dc sx,300x600,36.303157,6705,5268,7,3,2,1
USD,ttd spanish sx,320x50,822.881519,431090,400075,376,369,81,288
USD,zt perf arts black sx 5,300x250,0.486154,117,77,0,4,0,4
USD,African American Interests sx,728x90,0.066068,8,8,0,0,0,0
USD,Mogo DBM premium video sx,200x200,0.282192,18,18,0,1,0,1
USD,Nashville Symphony black list all adgroups,300x600,24.135243,1746,1524,2,64,6,58
USD,mogo marks branding comp rate silver video sx,160x600,12933.41876,3848994,3452902,1636,5358,442,4916
USD,mogo marks perf arts silver sx,970x90,1.428712,74,39,0,0,0,0
USD,mogo marks perf arts sx 7,468x60,0.004844,2,0,0,0,0,0
USD,mogo sf local sx,200x200,0.014558,2,1,0,0,0,0
USD,/All Apps/Google Play/Communication,300x50,1.795208,366,346,0,0,0,0
USD,/All Apps/Google Play/Games,728x90,75.901428,78675,76418,121,15,14,1
USD,PAC Singapore Rugby sx,300x600,1.134531,38,32,0,0,0,0
USD,Performing Arts Fort Worth Test List,300x600,51.324615,6286,5553,5,16,0,16
USD,co top 41 converting,300x250,43.021365,6042,4685,2,12,0,12
USD,kid safe sx,160x600,3316.209706,1340905,1236379,271,904,97,807
USD,mogo marks coupon sx,970x250,0.023593,11,0,0,0,0,0
USD,mogo marks outbound kpi sx x1a,320x100,9.838465,666,493,1,4,0,4
USD,mogo marks perf arts sx 6,200x200,0.03082,2,1,0,0,0,0
USD,mogo marks xsl_74205 (4p dims) sx ,728x90,7708.501827,833252,603111,319,2756,134,2622
USD,mogo perf arts sx,970x250,3822.856008,262224,216901,488,1120,252,868
USD,/All Apps/Google Play/Games/Strategy,300x600,0.94852,29,29,0,0,0,0
USD,DCPA video local sx,320x50,147.570929,36551,32547,34,72,0,72
USD,DO NOT USE Mobile - MoPub - Computers & Electronics/Software/Business & Productivity Software,320x50,0.71484,596,582,1,0,0,0
USD,DO NOT USE OAM UK,320x100,1.10712,133,127,1,1,1,0
USD,Pac Fox Atlanta EXCLUSION List,300x250,969.720422,222097,180987,99,217,21,196
USD,dbm native sx (adx),336x280,13.920471,1372,1229,0,2,0,2
USD,iab aff-im black sx,300x600,17.820651,877,825,1,0,0,0
USD,mogo marks agg sx xsl37589,160x600,47224.7442,12455570,11014968,5358,23913,1689,22224
USD,mogo marks lal branding (All) silver sx,970x250,8700.327149,685838,574650,1256,3105,550,2555
USD,mogo marks san francisco sx,300x50,36.179499,4234,3911,2,39,0,39
USD,/All Apps/Google Play/Games/Casual,300x250,24.176817,5529,5314,44,6,6,0
USD,Android Top Selling Free Weather,970x250,0.040221,5,5,0,0,0,0
USD,mogo marks xsl_ks20780 sx,468x60,10.249627,3304,2168,0,1,0,1
USD,/All Apps/Google Play/Games/Board,300x250,7.666487,751,654,13,2,2,0
USD,fgu test public channel,728x90,3262.170671,376546,238788,211,772,50,722
USD,mogo marks branding elite tier sx xls37852,300x50,32.341183,2198,2082,3,61,1,60
USD,mogo marks natl canada cat-aff-im sx,336x280,0.911934,48,35,0,1,0,1
USD,mogo marks natl cat-aff-im sx 2,160x600,2905.285713,329945,269980,152,1000,50,950
USD,mogo marks perf arts sx 11,200x200,0.014553,1,0,0,0,0,0
USD,mogo marks video sx xsl44760 class c,300x50,667.228268,112790,107181,55,1750,29,1721
USD,mogo marks xsl_74205 (2p dims) sx ,320x100,25.496135,6756,6301,10,18,3,15
USD,mogo marks xsl_800p sx,240x400,0.064794,6,4,0,0,0,0
USD,pac canada sports sx,300x100,0.050601,12,10,0,0,0,0
USD,/All Apps/Google Play/Productivity,300x250,8.566551,518,316,2,1,0,1
USD,DO NOT USE Spanish Language Sites,300x50,10.207658,2884,2743,1,14,0,14
USD,DO NOT USE Tier 2,320x51,0.8361,20,19,0,0,0,0
USD,DO NOT USE Tier 2* (CHANNEL),336x280,9.016891,1450,1242,1,7,0,7
USD,mogo cult soph sx,320x100,18.851089,5529,5013,24,23,8,15
USD,mogo education sx,320x50,2262.429389,1184079,1114720,762,1076,195,881
USD,mogo marks bay area sx,300x250,1850.21205,323501,187356,169,679,88,591
USD,mogo marks bwwpb sx,250x250,0.009307,5,0,0,0,0,0
USD,mogo marks hq100p sx,300x250,63349.76148,12303546,9867863,7023,23505,2215,21290
USD,mogo marks kpi achievers sx,300x50,6.651033,578,531,0,17,0,17
USD,mogo marks lal branding (All) gold sx,300x600,17698.15754,1233943,1069212,1578,9457,614,8843
USD,mogo marks visual arts sx,300x250,8.185477,12402,6098,5,6,0,6
USD,DO NOT USE All Google Anonymous,300x600,0.136566,14,12,0,0,0,0
USD,DO NOT USE AppNexus - Collective Media,250x250,16.179684,1643,1385,0,1,0,1
USD,DO NOT USE Tier 1* (CHANNEL),300x100,1.8676,390,341,1,0,0,0
USD,Portland Center Stage KPI sx,300x600,0.655734,123,102,0,0,0,0
USD,mogo marks perf arts sx 7,970x250,224.477326,12818,7319,26,139,62,77
USD,ttd gaming sx,468x60,0.418629,212,118,0,0,0,0
USD,/All Apps/Apple App Store/Food & Drink,320x50,41.070678,13303,12569,15,0,0,0
USD,DO NOT USE Spanish Language Sites,120x600,0.000711,1,0,0,0,0,0
USD,Mogo DBM select video sx,300x600,1966.66532,221386,205996,108,1031,45,986
USD,Provident High CTR List ,728x90,94.258709,8627,8060,4,0,0,0
USD,mogo biz-fi sx,250x250,1.102715,93,85,0,1,0,1
USD,mogo marks branding tier 2 sx xls37852,300x250,70985.18752,10680874,8090129,7511,29981,2555,27426
USD,mogo marks cincinnati sx,300x50,1.066985,191,178,1,1,0,1
USD,mogo marks xsl66781 sx,300x250,32174.60692,5355169,4237085,3648,12017,1135,10882
USD,mogo music sx,320x50,542.019034,103557,94615,67,351,46,305
USD,ttd education sx,160x600,3513.411268,827806,739272,517,2594,131,2463
USD,ttd shopping sx,200x200,0.209768,18,15,0,0,0,0
USD,/All Apps/Apple App Store/Games/Arcade,160x600,0.010459,1,1,0,0,0,0
USD,DO NOT USE Invite US Expandable Enabled Sites,320x50,2001.75813,784328,711132,732,919,200,719
USD,Lynn Grad,336x280,0.06831,8,8,0,0,0,0
USD,Performing Arts Fort Worth Perf Arts 5 black sx,300x250,4.483568,810,692,1,3,0,3
USD,bbb kpi sx (2019),320x50,195.128284,27724,26257,8,167,6,161
USD,mogo black sx,728x90,2709.029459,890385,830346,334,1026,77,949
USD,mogo lydia peacecenter test,240x400,0.02323,5,1,0,0,0,0
USD,mogo marks dallas sx,728x90,225.201787,51107,43999,12,184,5,179
USD,mogo marks native standard reach (no) tail aggregate sx,300x250,72634.6348,14495962,11377839,8175,29999,2412,27587
USD,mogo marks xsl_ks0001 sx,900x90,0.001275,1,1,0,0,0,0
USD,mogo marks xsl_ks20780 sx,970x250,11144.07189,1402250,1218111,2020,3823,748,3075
USD,Android Top Selling Free Business,300x250,2.324346,323,285,5,0,0,0
USD,mogo canada t1 sx,320x100,66.173274,8970,8510,15,14,10,4
USD,mogo marks branding tier 1 sx xls37852,160x600,32665.73343,9133691,8089323,3523,16084,1243,14841
USD,sfoc 2018 marks stratford premium sx,300x600,1260.134978,212555,198063,206,1611,184,1427
USD,ttd family parent sx,300x600,356.471312,56650,49114,33,161,4,157
USD,Channel of Top US Sites for Nielsen Video Ads - DO NOT EDIT,320x51,0.837271,21,20,0,0,0,0
USD,DO NOT USE Tier 1,970x250,8197.504915,958368,840311,1457,2840,550,2290
USD,Pac Private Events/Wedding sx,300x250,253.76333,23618,16933,19,107,6,101
USD,dbm native sx (adx),468x60,0.251354,49,46,0,0,0,0
USD,mogo marks bay area sx,250x250,0.206981,18,15,0,0,0,0
USD,mogo marks branding tier 2 sx xls37852,250x250,18.200883,1852,1533,3,4,0,4
USD,mogo marks perf arts sx 5 epx1,728x90,2308.095232,233555,169992,112,617,40,577
USD,mogo marks video branding medium reach tail aggregate sx,320x50,83664.29251,23186109,21551389,25246,33038,9227,23811
USD,sfoc cix sx,320x50,8.288867,1699,1637,0,15,0,15
USD,ttd entertainment sx,300x100,0.153579,28,27,0,0,0,0
USD,ttd female sx,468x60,0.070516,12,11,0,0,0,0
USD,ttd music sx,320x50,1908.268558,560533,512785,861,611,264,347
USD,/All Apps/Apple App Store/News,300x250,3044.153274,930037,802914,1173,44,25,19
USD,/All Apps/Apple App Store/Weather,300x50,13.968604,2714,2585,11,0,0,0
USD,kid safe sx,320x50,10920.40545,2107413,1949756,3622,3764,947,2817
USD,mogo marks hq100p sx,250x250,22.671561,2851,2306,0,3,0,3
USD,mogo marks natl cat-aff-im sx 2,728x90,8925.761372,1125915,780542,409,3380,155,3225
USD,mogo marks t1 brand kpi sx x8t,160x600,1639.623666,110097,82080,67,467,23,444
USD,mogo marks xsl_74205 sx ,300x250,39559.62947,7526371,6091161,5121,15696,1539,14157
USD,sfoc mogo youtube sx,Unknown,344.94229,10416,9928,11,1,0,1
USD,Diablo DVC Shortlist (Advertiser Level),300x50,516.378251,72622,68277,28,3592,54,3538
USD,Duxiana - Underperformance Blacklist,320x50,720.850242,335901,309970,273,15,9,6
USD,mogo marks natl canada cat-aff-im sx,468x60,0.004844,2,0,0,0,0,0
USD,mogo marks wine sx,300x600,13.864928,1522,1229,1,8,0,8
USD,mogo marks xsl66781 sx,250x250,14.259511,2405,2035,0,1,0,1
USD,mogo marks xsl_800p sx,300x50,2053.487298,363573,342614,163,6034,134,5900
USD,/All Apps/Apple App Store/Lifestyle,320x50,825.051111,275100,251255,491,16,3,13
USD,Channel of Top Global Sites for Nielsen Video Ads - DO NOT EDIT,320x100,273.959486,47598,44180,67,141,22,119
USD,Mogo DBM basic video sx,320x100,5.681034,638,582,2,1,1,0
USD,mogo marks agg sx xsl37589,320x50,112359.5887,30639160,28205320,32663,44857,11254,33603
USD,mogo marks native medium reach tail aggregate sx,970x250,8921.459755,1188165,1040211,1672,3420,604,2816
USD,mogo marks natl cat-aff-im sx 3,200x200,0.014553,1,0,0,0,0,0
USD,mogo marks opera sx,300x250,9.339769,530,476,2,8,1,7
USD,mogo marks pav kpi sx 3,970x90,18.824969,1325,1146,1,3,0,3
USD,mogo marks perf arts branding high reach sx,320x100,10.981434,932,703,0,16,0,16
USD,mogo marks video branding max reach tail aggregate sx,120x600,5.138338,1141,902,0,0,0,0
USD,mogo marks video sx xsl44760 class a,320x50,216.089711,67927,56930,36,149,18,131
USD,ttd travel sx,970x90,15.045133,636,541,4,1,0,1
USD,/All Apps/Google Play,300x50,259.369888,49940,47305,101,25,5,20
USD,DO NOT USE Mobile - MoPub - Online Communities,300x250,13.057101,4218,3857,12,1,1,0
USD,DO_NOT_USE Bid Manager reportable sites channel (Soon to be deprecated and please exclude channel: Non-reportable sites and apps),320x51,0.837271,21,20,0,0,0,0
USD,NYPR whitelist sx (Advertiser Level),300x250,38.91643,865,812,1,4,0,4
USD,Performing Arts Fort Worth sx,320x50,332.843313,144222,137414,108,242,73,169
USD,mogo marks branding comp rate silver video sx,970x250,6488.934142,869906,762448,1223,2071,396,1675
USD,mogo marks branding drhbx silver sx,970x250,8993.400092,786501,663427,1482,3325,657,2668
USD,mogo marks dallas sx,160x600,2.535693,373,198,0,4,0,4
USD,mogo marks natl cat-aff-im sx 2,320x50,12418.09418,2354239,2207434,4197,4244,1244,3000
USD,ttd auto sx,320x100,0.748086,165,133,0,0,0,0
USD,/All Apps/Apple App Store/Games/Card,160x600,155.400787,3122,3003,539,14,14,0
USD,Android Top Selling Free Music and Audio,320x100,0.021951,32,26,0,0,0,0
USD,DO NOT USE Tier 1* (CHANNEL),970x90,151.990683,10812,9161,9,10,1,9
USD,Duxiana - KPI sx,300x600,964.001188,83235,74801,131,27,7,20
USD,Duxiana - Underperformance Blacklist,160x600,51.212004,55582,48257,39,6,0,6
USD,mogo education sx,468x60,0.087466,42,33,0,0,0,0
USD,mogo marks branding max reach sx,300x600,54365.25119,6624870,5471945,5996,25649,2238,23411
USD,mogo marks jazz & blues sx,160x600,19.084483,3365,3137,0,5,0,5
USD,mogo marks pav kpi sx 3,300x50,36.510358,4204,4044,8,112,5,107
USD,mogo marks perf arts sx 5 rx1,728x90,2685.85484,264306,191237,124,770,44,726
USD,mogo marks xsl_ks0001 sx,336x280,35.850431,4460,3878,0,10,0,10
USD,mogo sports sx,336x280,1.990055,191,150,0,0,0,0
USD,sfoc pslx 2019 sx (Mar_2019),320x50,2987.805131,1162634,1109272,1200,5130,736,4394
USD,ttd travel sx,300x50,11.646604,3158,2964,0,22,0,22
USD,/All Apps/Google Play/Games/Educational,300x600,0.194839,11,10,1,0,0,0
USD,DO NOT USE Invite US Expandable Enabled Sites,468x60,0.008634,1,1,0,0,0,0
USD,Pac Fox Atlanta EXCLUSION List,320x51,0.001171,1,1,0,0,0,0
USD,RCU KPI Sitelist 1 (CPA),320x50,318.263939,22303,21162,11,69,0,69
USD,Stratford KPI revised,300x600,202.10611,21283,19516,31,336,35,301
USD,Top Performing Sites,320x50,600.896117,604716,512204,262,173,88,85
USD,mogo marks branding tier 1 sx xls37852,336x280,29.362038,3140,2721,0,9,0,9
USD,mogo marks perf arts sx 5 rx1,320x50,2363.816026,289388,243189,256,1209,113,1096
USD,mogo marks ticketing sx,336x280,0.066358,3,3,0,1,0,1
USD,mogo marks lal (purchase) silver sx,320x51,0.8361,20,19,0,0,0,0
USD,mogo marks lal branding (All) platinum sx,320x51,0.8361,20,19,0,0,0,0
USD,mogo marks xsl_74205 (4p dims) sx ,320x100,8.765242,445,292,0,4,0,4
USD,provident shortlist ,320x50,59797.81642,15438295,14253956,18233,22365,6999,15366
USD,ttd gaming sx,970x66,0.013193,32,2,0,0,0,0
USD,ttd health wellness sx,300x600,601.363514,36998,32324,47,296,11,285
USD,ttd news sx,300x250,46779.53023,9674096,7585370,5376,13436,1610,11826
USD,ttd shopping sx,300x100,0.007841,1,1,0,0,0,0
USD,/All Apps/Apple App Store/Utilities,300x50,7.276569,2707,2564,6,0,0,0
USD,/All Apps/Google Play/Finance,728x90,1.531123,357,328,0,0,0,0
USD,DCPA video local sx,970x250,2.865915,112,84,2,2,2,0
USD,mogo marks branding comp rate gold video sx,200x200,0.628575,93,90,0,0,0,0
USD,mogo marks pav kpi sx 2,728x90,7761.120998,790810,564806,315,2369,124,2245
USD,mogo music sx,468x60,0.031694,35,30,0,0,0,0
USD,sfoc pslx 2019 sx (Mar_2019),728x90,1913.663399,468934,434240,276,3407,217,3190
USD,/All Apps/Apple App Store/Games/Board,300x600,941.452904,37222,31368,3037,505,469,36
USD,/All Apps/Google Play/Lifestyle,160x600,0.111733,4,4,0,0,0,0
USD,Channel of Top US Sites for Nielsen Display Ads - DO NOT EDIT,320x50,121047.2843,36310343,33582576,35595,43886,11552,32334
USD,DO NOT USE Mobile - MoPub - Arts & Entertainment/Entertainment Industry/Recording Industry,300x50,0.01878,12,12,0,0,0,0
USD,DO NOT USE Tier 2,200x200,0.254058,96,46,0,0,0,0
USD,mogo marks disney sx,160x600,10.076811,1039,797,0,2,0,2
USD,mogo marks video sx xsl44760 class b,250x250,14.029478,2067,1610,0,4,0,4
USD,ttd weather sx,728x90,930.513251,109076,70786,68,246,29,217
USD,Fan Extender IMG/Sidearm Blacklist,300x250,0.63831,85,45,0,0,0,0
USD,dso kpi audx sx,970x250,13.19794,641,597,0,24,0,24
USD,mogo cult soph sx,300x250,25794.38508,4541563,3418397,3114,8486,924,7562
USD,ttd travel sx,728x90,3198.558041,287403,194354,356,1124,53,1071
USD,BR Native sx,970x250,260.035476,12279,10908,24,54,5,49
USD,GG KPI sx,970x250,0.260044,6,6,1,1,1,0
USD,mogo marks xsl_ks20780 sx,300x600,48702.541,5930297,4904247,5313,22991,2040,20951
USD,/All Apps/Apple App Store/Utilities,970x250,0.119456,2,1,0,0,0,0
USD,/All Apps/Google Play/Communication,320x100,0.00138,5,4,0,0,0,0
USD,/All Apps/Google Play/Shopping,300x600,0.639486,9,8,0,0,0,0
USD,Android Top Selling Free Books and Reference,300x600,31.314769,996,919,21,14,13,1
USD,DO NOT USE AppNexus - Collective Media,200x200,0.584472,105,56,0,1,0,1
USD,DO_NOT_USE Bid Manager reportable sites channel (Soon to be deprecated and please exclude channel: Non-reportable sites and apps),300x100,3.43375,663,589,1,0,0,0
USD,PAC Singapore Rugby sx,320x50,13.222394,1616,1284,0,5,0,5
USD,Performing Arts Fort Worth Test List,320x50,51.712352,9758,6668,9,32,9,23
USD,dbm native sx (adx),250x250,11.464514,1654,1258,0,1,0,1
USD,iab aff-im black sx,320x50,28.034575,1571,1460,2,1,0,1
USD,mogo marks native sx xsl1045 class c,300x100,0.280298,47,36,0,0,0,0
USD,mogo marks perf arts sx 5 rx1,336x280,0.997377,39,31,0,2,0,2
USD,mogo marks perf arts sx 7,300x600,190.97991,17875,10094,11,66,3,63
USD,mogo marks phoenix sx,300x250,466.556034,174358,64281,148,165,60,105
USD,/All Apps/Google Play/Games/Board,728x90,3.947125,5102,5070,6,1,1,0
USD,/All Apps/Google Play/Music & Audio,320x100,0.003594,6,6,0,0,0,0
USD,Channel of Top US Sites for Nielsen Video Ads - DO NOT EDIT,300x100,3.912375,794,709,1,0,0,0
USD,DO NOT USE Tier 1,970x90,151.990683,10812,9161,9,10,1,9
USD,mogo marks natl canada cat-aff-im sx,250x250,0.028548,12,6,0,0,0,0
USD,ttd weather sx,336x280,1.207284,60,55,0,0,0,0
USD,/All Apps/Apple App Store/Games/Adventure,300x250,0.056235,3,3,1,0,0,0
USD,/All Apps/Google Play/Education,336x280,0.003019,2,2,0,0,0,0
USD,/All Apps/Google Play/Finance,336x280,0.006038,3,3,0,0,0,0
USD,/All Apps/Google Play/Games/Strategy,320x50,1.475126,2075,2029,11,1,1,0
USD,Performing Arts Fort Worth Test List,728x90,32.510684,3348,2224,1,27,0,27
USD,gostanford.com,728x90,0.079309,2,2,0,1,0,1
USD,magic theatre top performing sx,160x600,20.573379,4494,3478,0,10,0,10
USD,mogo marks broadway sx,200x200,0.03082,2,1,0,0,0,0
USD,mogo marks natl cat-aff-im sx 3,970x90,20.713826,1586,1373,2,3,0,3
USD,mogo marks pav kpi sx 2,336x280,11.769526,877,798,0,2,0,2
USD,mogo marks perf arts platinum sx,200x200,0.018275,2,1,0,0,0,0
USD,mogo marks t1 brand kpi sx x8t,300x250,31213.42625,5630505,4712837,3566,9797,1080,8717
USD,/All Apps/Apple App Store/Games/Dice,300x50,0.042033,15,15,0,0,0,0
USD,/All Apps/Apple App Store/Health & Fitness,728x90,6.866176,8601,8541,13,0,0,0
USD,/All Apps/Apple App Store/Shopping,320x50,20.895421,13710,11125,9,0,0,0
USD,Channel of Top non-US Sites for Nielsen Video Ads - DO NOT EDIT,320x50,44017.88121,15354590,14438328,11919,16858,3301,13557
USD,education master sx,300x50,450.802638,87748,82787,50,1310,38,1272
USD,mogo financial services kpi sx,300x100,0.003136,1,1,0,0,0,0
USD,mogo marks branding increased reach sx,120x600,9.369644,1956,1623,1,0,0,0
USD,mogo marks hq100p sx,200x200,0.305819,19,18,0,1,0,1
USD,mogo marks visual arts sx,970x250,0.302413,330,196,1,0,0,0
USD,ttd education sx,970x90,17.770696,1646,1476,2,4,0,4
USD,Channel of Top US Sites for Nielsen Display Ads - DO NOT EDIT,320x100,402.298193,59981,55428,101,189,34,155
USD,GG KPI sx,160x600,11.350638,623,532,1,1,0,1
USD,Lynn Grad,300x250,697.734155,166657,157072,46,285,28,257
USD,mogo marks lal (purchase) gold sx,120x600,1.850574,131,104,0,0,0,0
USD,mogo marks perf arts branding high reach sx,300x250,5979.410031,480144,366210,520,2454,223,2231
USD,ttd male sx,728x90,3837.281029,1082937,925166,425,1672,110,1562
USD,DO NOT USE Mobile - MoPub - Games/Computer & Video Games/Music & Dance Games,320x50,20.312376,42534,42388,59,0,0,0
USD,mogo marks branding tier 2 sx xls37852,200x200,0.930668,61,55,0,1,0,1
USD,mogo marks bw-theatre sx,320x50,16.761961,1904,1461,2,8,1,7
USD,mogo marks chicago sx,336x280,0.007736,1,1,0,0,0,0
USD,mogo marks xsl66781 sx,200x200,0.137813,7,6,0,0,0,0
USD,mogo marks xsl_800p sx,468x60,5.218799,1857,1044,0,0,0,0
USD,sfoc pslx 2018 sx (Jun_2018_Archived),728x90,1668.928438,380857,352750,208,2925,148,2777
USD,BR Native sx,160x600,27.703626,3408,3152,2,4,1,3
USD,Lynn DMAC,728x90,16.780781,3619,3397,1,8,0,8
USD,mogo marks branding increased reach sx,300x50,3142.520675,573302,541335,285,9017,209,8808
USD,mogo marks broadwayworld sx,250x250,0.009307,5,0,0,0,0,0
USD,mogo marks toronto sx,300x250,1527.414884,249529,223653,181,1141,101,1040
USD,ttd sports sx,728x90,5265.059888,808160,649176,267,1155,56,1099
USD,DO NOT USE Tier 1,300x600,28535.05479,3046280,2549414,3534,12881,1316,11565
USD,mogo marks nyt sx,970x90,14.288386,673,592,1,2,0,2
USD,mogo marks perf arts sx 5 rx1,320x100,13.487068,1114,851,1,11,0,11
USD,pac canada sports sx,250x250,0.956509,126,87,0,0,0,0
USD,ttd tech sx,300x50,47.121577,6485,6148,0,197,0,197
USD,/All Apps/Google Play/Communication,320x50,32.537066,32492,29570,64,5,3,2
USD,Stratford KPI sx,320x50,52.43082,5347,5104,9,139,5,134
USD,cmt perf arts black sx 7,320x50,0.749853,64,56,0,0,0,0
USD,education master sx,970x90,33.34356,2384,2120,3,6,0,6
USD,kid safe sx,320x100,17.564349,7756,6920,4,21,2,19
USD,mogo marks branding comp rate platinum video sx,468x60,0.005764,3,2,0,0,0,0
USD,mogo marks elite kpi achievers sx,300x600,1538.951711,121585,94594,124,557,56,501
USD,mogo marks natl cat-aff-im sx,320x50,13500.54931,2629680,2453472,4484,4607,1344,3263
USD,mogo marks natl cat-aff-im sx,728x90,11293.1165,1632130,1097026,600,4153,255,3898
USD,mogo marks outbound kpi sx x1a,336x280,2.242297,228,191,0,1,0,1
USD,mogo marks perf arts gold sx,728x90,1067.661676,86665,54001,57,362,26,336
USD,ttd music sx,320x100,1.201326,709,580,0,0,0,0
USD,bbb kpi sx (2019),160x600,9.912297,453,421,0,6,0,6
USD,mogo marks branding drhbx platinum sx,320x100,18.314127,2363,2217,3,15,1,14
USD,mogo marks disney sx,728x90,159.583569,20868,16253,8,63,3,60
USD,mogo marks expedia sx,320x50,0.549868,147,55,0,0,0,0
USD,ttd health sx,468x60,0.086391,47,29,0,0,0,0
USD,mogo marks native high reach tail aggregate sx,320x50,84632.094,21522178,20010854,24737,33320,9212,24108
USD,mogo marks shakespeare sx,300x250,52.699431,6049,4250,10,6,4,2
USD,/All Apps/Apple App Store/Music,300x250,186.406656,108817,106506,98,3,3,0
USD,DO NOT USE Mobile - MoPub - Business & Industrial,320x50,0.273739,113,107,0,0,0,0
USD,DO NOT USE OAM UK,336x280,0.033688,7,4,0,0,0,0
USD,Duxiana- Bad Site List(Allan) ,300x250,69.319821,21925,19285,40,1,0,1
USD,Portland Center Stage Perf Arts 5 black sx,300x250,0.010905,4,4,0,0,0,0
USD,mogo marks agg sx xsl37589,320x100,396.289828,64219,59161,110,222,29,193
USD,mogo marks jazz & blues sx,728x90,159.727927,32429,27258,11,47,2,45
USD,mogo marks san francisco sx,320x50,1272.781828,230123,211390,325,421,119,302
USD,mogo marks video branding medium reach tail aggregate sx,320x100,280.272153,44756,41865,89,112,24,88
USD,ttd beauty sx,250x250,0.319661,34,34,0,0,0,0
USD,ttd tech sx,970x90,11.073462,1198,1104,2,2,0,2
USD,/All Apps/Apple App Store/Productivity,728x90,33.324542,11695,11426,35,2,2,0
USD,5a kpi sx,728x90,8.681226,298,216,1,0,0,0
USD,Android Top Selling Free Game,300x50,100.370264,16383,15978,65,2,1,1
USD,Broadway sx,160x600,6.465737,149,135,1,1,0,1
USD,Channel of Top non-US Sites for Nielsen Display Ads - DO NOT EDIT,200x200,3.064474,454,307,0,2,0,2
USD,Mogo DBM basic video sx,970x66,0.048357,15,2,0,0,0,0
USD,SP black sx,300x250,1.67091,150,71,0,1,0,1
USD,mogo financial services kpi sx,728x90,3826.367405,877046,588692,918,2002,83,1919
USD,mogo lydia peacecenter test,200x200,0.212206,2,2,0,0,0,0
USD,mogo marks branding elite tier sx xls37852,320x50,2360.006727,291950,270041,300,1426,126,1300
USD,mogo marks branding increased reach sx,970x90,391.612146,29668,25622,31,33,1,32
USD,mogo marks natl cat-aff-im sx 2,320x100,15.213979,2199,1852,6,8,3,5
USD,mogo marks video sx xsl44760 class c,320x50,41073.52141,10242910,9552323,13428,16510,5867,10643
USD,mogo mba tier 2 sx,250x250,0.900566,91,79,0,0,0,0
USD,/All Apps/Google Play/Weather,300x250,28.452085,4183,2717,13,4,1,3
USD,DO NOT USE Spanish Language Sites,468x60,0.003798,2,0,0,0,0,0
USD,dso kpi audx sx,728x90,8.150059,927,869,0,13,0,13
USD,mogo jacks education sx,300x250,0.864567,306,275,0,0,0,0
USD,mogo marks broadway sx,970x250,219.608315,12547,7093,26,137,62,75
USD,mogo marks bwwpb sx,200x200,0.014553,1,0,0,0,0,0
USD,mogo marks natl cat-aff-im sx,320x100,17.179012,2728,2339,6,8,3,5
USD,mogo marks natl elite cat-aff-im sx,300x50,30.031005,3145,3028,5,89,2,87
USD,pac esports sx,970x90,2.968203,104,102,0,0,0,0
USD,ttd female sx,250x250,1.664704,175,157,0,0,0,0
USD,BR Native sx,728x90,67.454279,12104,11483,2,21,0,21
USD,DO NOT USE Mobile - MoPub - Arts & Entertainment/Entertainment Industry/Recording Industry,728x90,16.245648,27832,27717,4,0,0,0
USD,DO NOT USE OAM FR,300x600,8.91756,1846,1575,0,1,0,1
USD,mogo marks broadwayworld sx,300x250,1427.709843,89279,49839,127,656,57,599
USD,mogo marks xsl_74205 sx ,468x60,0.006997,3,1,0,0,0,0
USD,ocfta perf arts black sx 5,970x250,0.26266,12,11,0,0,0,0
USD,provident shortlist ,200x200,1.493936,299,192,0,0,0,0
USD,ttd entertainment sx,250x250,8.815618,1051,849,0,0,0,0
USD,ttd finance sx,468x60,0.02647,9,9,0,0,0,0
USD,Android Top Selling Free Social,300x50,11.246089,1638,1571,6,1,1,0
USD,DO NOT USE Tier 3,300x600,10315.33531,1341645,1079437,1064,5449,325,5124
USD,mogo marks native sx xsl1045 class b,970x250,566.371109,314976,297296,352,265,36,229
USD,mogo marks playbill sx x3e,970x250,65.349257,6905,3375,9,44,4,40
USD,mogo marks t1 brand sx trim,120x600,0.570847,75,61,0,0,0,0
USD,mogo marks video branding max reach tail aggregate sx,160x600,34969.36138,10167293,9043553,4096,17530,1314,16216
USD,/All Apps/Apple App Store/Finance,300x50,0.387767,118,109,0,0,0,0
USD,Cal Performances Perf Arts 5 5 black sx,300x250,100.877505,8272,7118,4,2,0,2
USD,DCPA display local sx,160x600,0.233209,13,11,0,0,0,0
USD,DO NOT USE Tier 2* (CHANNEL),300x50,487.341027,67575,64249,27,1831,17,1814
USD,DO NOT USE Tier 3* (CHANNEL),250x250,28.513369,3416,2774,0,7,0,7
USD,GG KPI sx,728x90,105.566365,3062,2692,5,12,0,12
USD,Nashville Symphony black sx,300x250,1.473282,246,205,0,1,0,1
USD,mogo black rt sx,160x600,0.863239,75,67,0,0,0,0
USD,mogo marks branding drhbx platinum sx,970x66,0.000943,6,0,0,0,0,0
USD,mogo marks branding elite tier sx xls37852,320x100,12.964575,923,698,1,12,0,12
USD,mogo marks kpi achievers sx,468x60,0.514759,171,154,0,0,0,0
USD,mogo marks native high reach tail aggregate sx,320x100,271.081964,36742,34135,81,114,28,86
USD,mogo marks video branding medium reach tail aggregate sx,970x66,1.01214,514,153,0,0,0,0
USD,mogo marks video sx xsl44760 class c,320x100,93.746574,23259,21801,51,74,15,59
USD,/All Apps/Apple App Store/Utilities,320x50,458.293513,162593,155639,183,9,5,4
USD,/All Apps/Apple App Store/Utilities,728x90,173.351039,26968,26058,71,3,1,2
USD,Cal Perf KPI sx ,300x600,202.440615,85173,33513,23,5,0,5
USD,mogo marks pav kpi sx 3,728x90,5500.542129,447237,351693,199,1571,85,1486
USD,mogo marks perf arts platinum sx,970x250,285.944351,18182,11426,48,182,69,113
USD,ttd shopping sx,300x600,610.55486,29829,25213,33,175,15,160
USD,/All Apps/Apple App Store/Photo & Video,300x50,0.672679,324,307,0,0,0,0
USD,/All Apps/Google Play,336x280,0.534922,142,104,1,2,2,0
USD,DO NOT USE AppNexus - Collective Media,468x60,1.075839,497,301,0,0,0,0
USD,DO_NOT_USE Mobile - MoPub - Games,728x90,22.087613,13753,13109,25,1,1,0
USD,Stratford Black RT SX,970x250,3.448128,229,215,3,2,2,0
USD,mogo black sx,970x90,4.924719,775,677,1,1,0,1
USD,mogo marks native (sharethrough) unique us sx,320x50,24922.64431,7380143,6868632,7328,8324,1900,6424
USD,mogo marks video branding max reach tail aggregate sx,336x280,79.177355,13168,11363,8,23,0,23
USD,mogo marks xsl_74205 (2p dims) sx ,300x250,38893.90365,7474200,6049083,5063,15305,1508,13797
USD,sfoc marks kpi sx (062018),970x250,36.643808,1993,1598,1,32,0,32
USD,zt local austin sx,970x250,28.323888,2928,2259,7,18,2,16
USD,/All Apps/Apple App Store/Education,300x50,3.254346,1413,1327,2,0,0,0
USD,/All Apps/Apple App Store/Games/Action,970x250,0.073853,12,6,0,0,0,0
USD,DO NOT USE OAM UK,300x250,621.507019,93322,75831,72,286,12,274
USD,Lynn DMAC,160x600,303.28431,93896,81381,67,154,29,125
USD,mogo marks seattle sx,300x50,0.963438,175,166,0,0,0,0
USD,mogo t1 brand sx,300x250,45516.90028,9078570,6774036,5821,17016,1811,15205
USD,/All Apps/Apple App Store/Business,320x50,328.545923,229891,217564,135,6,5,1
USD,/All Apps/Google Play/Games/Simulation,300x50,0.088277,26,26,0,0,0,0
USD,mogo marks branding increased reach sx,240x400,0.283233,26,17,0,0,0,0
USD,mogo marks lal (purchase) gold sx,240x400,0.01986,2,1,0,0,0,0
USD,mogo marks native (sharethrough) unique can sx,300x100,0.505763,99,86,0,0,0,0
USD,mogo marks native sx xsl1045 class b,468x60,0.260216,70,53,0,0,0,0
USD,mogo marks natl canada cat-aff-im sx,300x50,7.991604,1271,1199,0,18,0,18
USD,mogo marks nyc sx,320x100,8.770532,448,295,0,4,0,4
USD,mogo marks perf arts sx 6,300x600,150.026147,12895,5735,6,44,4,40
USD,mogo marks xsl_800p sx,336x280,65.686814,6184,5411,1,27,0,27
USD,mogo music sx,970x90,0.003465,1,1,0,0,0,0
USD,sfoc stratford hqcat sx,320x50,321.935163,139426,134339,82,788,48,740
USD,/All Apps/Apple App Store/Newsstand,970x90,0.008705,5,5,0,0,0,0
USD,DSM African American sx,320x50,8.84033,698,637,3,2,0,2
USD,Mogo DBM premium video sx,300x600,16734.02203,1833947,1523880,1825,5797,662,5135
USD,dbm native sx (adx),300x50,177.303561,32730,31185,31,426,29,397
USD,mogo marks chicago sx,970x66,0.000322,1,1,0,0,0,0
USD,/All Apps/Apple App Store/Games/Sports,300x50,0.012526,10,8,0,0,0,0
USD,/All Apps/Google Play/Media & Video,300x600,3.859167,577,513,10,2,2,0
USD,/All Apps/Google Play/Transportation,300x250,0.031073,5,5,0,0,0,0
USD,/All Apps/Google Play/Travel & Local,300x50,0.703656,48,43,0,0,0,0
USD,mogo marks broadway sx,468x60,0.004844,2,0,0,0,0,0
USD,mogo marks high intenders sx,970x250,149.664011,13015,8488,24,110,16,94
USD,mogo marks pav kpi sx 2,300x100,0.153683,27,20,0,0,0,0
USD,mogo marks perf arts platinum sx,468x60,0.004844,2,0,0,0,0,0
USD,mogo marks perf arts sx 11,300x600,144.557549,12235,5385,6,43,4,39
USD,mogo sf local sx,300x600,989.943623,241029,126534,81,327,37,290
USD,ttd male sx,160x600,749.195627,572822,494513,76,203,29,174
USD,/All Apps/Apple App Store/Games/Card,300x600,325.624519,17039,15087,1206,120,106,14
USD,/All Apps/Apple App Store/Utilities,320x100,0.007777,6,6,0,0,0,0
USD,DCPA Video black sx,728x90,0.073341,8,6,1,0,0,0
USD,SP News Black sx,300x250,221.430275,50171,41992,41,254,44,210
USD,finn dallas native sx,160x600,355.691247,203486,178340,61,115,28,87
USD,mogo marks branding drhbx silver sx,120x600,2.411944,359,292,0,0,0,0
USD,sfoc rtx kpi sx,320x50,101.25062,40558,38723,36,175,20,155
USD,ttd tech sx,728x90,1107.128097,216132,174651,128,548,48,500
USD,/All Apps/Apple App Store/Games/Music,300x50,0.057279,3,3,0,0,0,0
USD,/All Apps/Google Play/Libraries & Demo,300x600,0.010839,1,1,0,0,0,0
USD,/All Apps/Google Play/Lifestyle,300x600,62.111068,1276,1233,33,5,5,0
USD,mogo marks branding increased reach sx,320x50,116260.0992,32900372,30301281,34171,46346,11815,34531
USD,mogo marks native medium reach tail aggregate sx,300x50,1717.339526,266888,253935,155,4416,120,4296
USD,pac motorsports sx,250x250,1.743342,339,277,0,0,0,0
USD,ttd auto sx,300x50,33.908576,2919,2735,1,182,1,181
USD,zt perf arts black sx 5,970x250,0.02001,10,4,0,0,0,0
USD,/All Apps/Apple App Store/Games/Dice,320x50,5.409261,4033,3964,14,0,0,0
USD,/All Apps/Apple App Store/Games/Strategy,300x50,0.002674,2,2,0,0,0,0
USD,DO NOT USE AppNexus - Collective Media,970x66,0.337691,280,22,0,0,0,0
USD,fgu test public channel,970x90,23.125749,967,845,2,0,0,0
USD,mogo marks branding increased reach sx,728x90,84516.13073,16587993,13404281,8236,45698,2695,43003
USD,mogo marks philadelphia sx,970x250,0.111751,5,5,0,0,0,0
USD,/All Apps/Apple App Store/Games/Family,970x250,0.106714,10,9,0,0,0,0
USD,/All Apps/Apple App Store/Social Networking,300x50,3.547113,1736,1670,6,0,0,0
USD,/All Apps/Google Play/Games/Trivia,320x50,76.637476,30092,27785,19,4,2,2
USD,Performing Arts Fort Worth black sx,300x250,0.362822,51,21,0,0,0,0
USD,arizona opera top converters sx,970x250,51.594477,2503,2305,9,20,5,15
USD,mogo lydia peacecenter test,970x90,55.155787,2617,2272,6,3,0,3
USD,mogo marks branding comp rate silver video sx,300x50,415.821794,97764,92387,41,1120,35,1085
USD,mogo marks houston sx,970x250,3.049485,222,148,0,1,0,1
USD,mogo marks native medium reach tail aggregate sx,120x600,3.427679,459,375,0,0,0,0
USD,mogo marks perf arts platinum sx,970x66,0.004991,1,0,0,0,0,0
USD,mogo marks xsl_74205 (4p dims) sx ,970x90,24.838997,1773,1525,1,3,0,3
USD,Channel of Top Global Sites for Nielsen Display Ads - DO NOT EDIT,200x200,6.313443,758,518,0,2,0,2
USD,DO NOT USE Mobile - MoPub - Arts & Entertainment/Music & Audio,300x50,0.01878,12,12,0,0,0,0
USD,Mogo DBM basic video sx,300x50,78.960225,20773,19712,14,124,11,113
USD,education master sx,728x90,11018.18063,1753564,1456997,960,5036,284,4752
USD,mogo marks branding comp rate silver video sx,120x600,1.599527,307,245,0,0,0,0
USD,mogo marks pav kpi hx,250x250,16.090113,2647,2257,0,2,0,2
USD,mogo marks perf arts silver sx,200x200,0.018275,2,1,0,0,0,0
USD,ttd news sx,160x600,2103.803704,422291,357583,295,759,89,670
USD,Channel of Top non-US Sites for Nielsen Display Ads - DO NOT EDIT,240x400,0.052541,4,3,0,0,0,0
USD,DO NOT USE Android Top Selling Free Media and Video,320x50,1.009438,2408,2294,7,3,3,0
USD,mogo marks branding elite tier sx xls37852,250x250,0.328562,26,17,0,2,0,2
USD,mogo marks native high reach tail aggregate sx,250x250,51.253248,6211,4971,4,8,0,8
USD,mogo marks nyc sx,970x90,14.793545,692,608,1,2,0,2
USD,mogo marks perf arts sx 2,320x50,3108.38517,457303,398609,399,1614,169,1445
USD,mogo marks video sx xsl44760 class c,250x250,28.11163,3666,2997,1,5,0,5
USD,provident shortlist ,300x250,77537.32803,14972030,12070059,8745,24965,2265,22700
USD,ttd gaming sx,160x600,1629.798598,1102909,957521,483,527,100,427
USD,/All Apps/Google Play/Social,300x600,234.259308,4261,3892,367,64,62,2
USD,mogo marks lal (purchase) platinum sx,120x600,1.394749,100,80,0,0,0,0
USD,mogo marks wedding sx,728x90,45.811108,3067,2755,1,21,1,20
USD,pac motorsports sx,320x50,3675.687221,523507,488268,361,742,61,681
USD,ttd entertainment sx,320x100,56.155298,8799,7761,17,42,6,36
USD,/All Apps/Apple App Store,160x600,172.795873,3814,3611,625,18,17,1
USD,Channel of Top US Sites for Nielsen Display Ads - DO NOT EDIT,300x250,175129.3812,37946276,30139094,19496,65880,5193,60687
USD,DO NOT USE Tier 3* (CHANNEL),320x100,209.88498,33510,31488,49,110,15,95
USD,RCU KPI Sitelist 1 (CPA),300x250,55.254716,3963,3699,0,8,0,8
USD,Top Performing Sites,300x250,4253.865169,1727539,1380865,635,364,128,236
USD,mogo canada t1 sx,200x200,0.051771,3,3,0,0,0,0
USD,mogo cult soph sx,200x200,0.137819,8,7,0,0,0,0
USD,mogo marks natl cat-aff-im sx,250x250,2.292497,217,194,0,0,0,0
USD,mogo marks perf arts sx 2,728x90,7628.069478,641914,492261,294,1797,108,1689
USD,mogo marks perf arts sx 5 rx1,300x250,5594.567481,433573,317942,429,1864,192,1672
USD,PAC Singapore sx,300x50,0.015841,2,2,0,0,0,0
USD,mogo centro sx US (2014),970x250,402.213863,46416,34818,65,135,35,100
USD,mogo marks elite kpi achievers sx,336x280,0.832751,47,34,0,1,0,1
USD,mogo marks los angeles sx,970x90,0.04629,8,7,0,0,0,0
USD,mogo marks ttd obx kitchen premium sink sx,900x90,0.001275,1,1,0,0,0,0
USD,mogo mba tier 2 sx,970x66,0.025054,4,3,0,0,0,0
USD,/All Apps/Google Play/Sports,728x90,14.329891,6323,6054,7,1,1,0
USD,mogo marks branding comp rate gold video sx,300x50,229.920253,47300,45050,20,463,28,435
USD,mogo marks branding comp rate platinum video sx,320x50,15702.34875,2413084,2256921,5372,6969,3650,3319
USD,mogo marks lal (purchase) gold sx,468x60,0.48606,112,67,0,0,0,0
USD,mogo marks pav kpi hx,728x90,11245.27704,1715033,1253760,677,3929,302,3627
USD,mogo marks san francisco sx,250x250,0.109648,11,9,0,0,0,0
USD,mogo marks t1 brand kpi sx x8t,970x250,5580.275186,500667,427775,844,1999,432,1567
USD,sfoc pslx 2019 sx (Mar_2019),300x250,2540.921367,590268,544894,310,4067,289,3778
USD,ttd female sx,320x100,3.486822,320,292,2,1,1,0
USD,ttd food sx,728x90,3626.319216,446085,392160,173,2452,76,2376
USD,/All Apps/Apple App Store/Photo & Video,320x50,191.568462,150610,148497,160,0,0,0
USD,/All Apps/Google Play/Games/Simulation,728x90,0.565168,359,341,2,0,0,0
USD,Channel of Top non-US Sites for Nielsen Display Ads - DO NOT EDIT,300x250,111286.3345,23361090,19148043,12282,41227,3283,37944
USD,Channel of Top non-US Sites for Nielsen Video Ads - DO NOT EDIT,320x100,176.939746,30766,28968,43,82,18,64
USD,Nashville Local sx,970x250,7.762586,333,291,0,9,0,9
USD,mogo marks sports sx,320x100,0.716679,54,42,0,0,0,0
USD,/All Apps/Google Play/Education,300x600,3.137746,134,125,1,0,0,0
USD,/All Apps/Google Play/Finance,300x600,4.513032,1756,1637,98,2,2,0
USD,/All Apps/Google Play/Travel & Local,320x50,35.411375,3249,2860,9,12,0,12
USD,DO NOT USE Mobile - MoPub - Beauty & Fitness/Fitness,300x50,1.582702,233,201,0,0,0,0
USD,mogo marks branding tier 3 sx xls37852,970x90,97.882816,7164,6278,12,12,1,11
USD,mogo marks high intenders sx,336x280,1.794975,107,104,0,0,0,0
USD,mogo marks lal branding (All) silver sx,300x50,1798.427631,251473,238397,128,5560,94,5466
USD,mogo marks video sx xsl44760 class a,250x250,9.604319,1246,936,0,2,0,2
USD,education master sx,160x600,4939.304732,1031415,914886,586,3011,148,2863
USD,mogo marks cincinnati sx,970x90,0.062934,15,12,0,0,0,0
USD,mogo marks native medium reach tail aggregate sx,240x400,0.097814,8,6,0,0,0,0
USD,mogo marks natl canada cat-aff-im sx,320x50,3698.396162,782272,725835,368,2349,184,2165
USD,mogo marks seattle sx,728x90,446.886736,192692,164303,51,122,14,108
USD,DCPA Video black sx,160x600,0.945654,241,207,0,0,0,0
USD,dbm native sx (adx),320x50,16741.85677,2789885,2613133,6168,6959,3813,3146
USD,mogo marks branding drhbx silver sx,240x400,0.062013,7,5,0,0,0,0
USD,mogo marks pav kpi sx 2,300x600,6567.253721,769113,682009,716,2598,308,2290
USD,sfoc pslx 2019 sx (Mar_2019),300x600,1535.147788,273707,253785,258,2120,210,1910
USD,ttd tech sx,160x600,835.288909,313393,278226,277,340,55,285
USD,/All Apps/Apple App Store/Education,320x50,139.500649,59783,57353,142,5,4,1
USD,/All Apps/Apple App Store/Games/Sports,728x90,0.63115,569,563,0,0,0,0
USD,Lynn General,160x600,703.824251,169117,153119,93,405,37,368
USD,mogo marks chicago sx,970x90,0.122988,19,18,0,0,0,0
USD,ttd weather sx,300x600,2877.871156,114705,100570,365,622,87,535
USD,Channel of Top non-US Sites for Nielsen Display Ads - DO NOT EDIT,320x50,66473.25383,20266916,18833031,18969,25700,7082,18618
USD,Pac Fox Atlanta EXCLUSION List,120x600,0.000859,1,1,0,0,0,0
USD,mogo marks nyc sx,250x250,1.191542,109,99,0,0,0,0
USD,mogo marks perf arts sx 5 epx1,160x600,1832.980302,116330,84345,82,605,34,571
USD,mogo marks video branding extended reach tail aggregate sx,728x90,42878.61912,8838911,6939605,4359,23515,1426,22089
USD,/All Apps/Google Play/Games/Puzzle,728x90,16.682576,14293,13774,22,1,1,0
USD,Android Top Selling Free Tools,320x50,10.404497,10689,10043,44,7,7,0
USD,mogo marks branding increased reach sx,970x66,1.288789,634,168,0,0,0,0
USD,mogo marks kpi mdx sx xls9297,300x600,5559.623654,559974,487270,558,2689,277,2412
USD,mogo marks native sx xsl1045 class c,240x400,0.021704,1,1,0,0,0,0
USD,mogo marks natl cat-aff-im sx 3,970x250,4332.201301,357340,298469,575,1511,327,1184
USD,/All Apps/Google Play/Games/Adventure,336x280,0.003824,2,2,0,0,0,0
USD,/All Apps/Google Play/Music & Audio,300x50,14.308014,3111,2951,2,0,0,0
USD,Android Top Selling Free Entertainment,728x90,27.026005,21448,21300,44,8,7,1
USD,Android Top Selling Free Game,300x600,689.680103,17632,16103,911,260,232,28
USD,Seattle Local sx,300x250,65.510561,26456,21717,11,8,0,8
USD,mogo marks t1 brand kpi sx x8t,468x60,0.004844,2,0,0,0,0,0
USD,/All Apps/Apple App Store/Games/Racing,300x250,0.026835,5,3,0,0,0,0
USD,DO NOT USE OAM UK,200x200,0.072404,45,5,0,0,0,0
USD,mogo marks denver sx,300x50,1.568227,333,306,1,0,0,0
USD,mogo marks los angeles sx,250x250,0.086523,9,5,0,0,0,0
USD,mogo marks outbound kpi sx x1a,200x200,0.014553,1,0,0,0,0,0
USD,mogo t1 brand sx,200x200,0.22285,17,15,0,1,0,1
USD,sfoc hqcat black hx,970x250,8.368287,122,108,0,2,0,2
USD,/All Apps/Apple App Store/Sports,300x50,5.578558,2047,1851,1,0,0,0
USD,/All Apps/Apple App Store/Travel,728x90,20.688167,7534,6736,18,1,1,0
USD,Belmont Sitelist v1,728x90,381.243478,47782,45190,63,222,73,149
USD,Brandcast Blacklist ,300x50,318.716104,51083,47110,15,1242,15,1227
USD,Channel of Top US Sites for Nielsen Video Ads - DO NOT EDIT,240x400,0.159617,17,10,0,0,0,0
USD,Western Black sx,970x250,15.021565,2907,2719,7,48,3,45
USD,mogo centro sx US (2014),468x60,0.006436,3,2,0,0,0,0
USD,mogo lydia peacecenter test,320x50,22319.6043,5089094,4591636,8272,8893,4293,4600
USD,mogo marks xsl_74205 (2p dims) sx ,200x200,0.018275,2,1,0,0,0,0
USD,mogo marks xsl_ks20780 sx,160x600,38473.5868,9880814,8719768,4500,19579,1426,18153
USD,mogo universal rt+ob black sx,970x250,0.212765,36,23,0,0,0,0
USD,ttd health wellness sx,970x66,0.013009,4,2,0,0,0,0
USD,/All Apps/Apple App Store/Education,728x90,18.215024,13638,13278,33,1,1,0
USD,fgu test public channel,300x50,0.006124,3,2,0,0,0,0
USD,mogo marks native sx xsl1045 class a,250x250,10.141668,1345,1008,2,1,0,1
USD,mogo marks natl canada cat-aff-im sx,970x250,4210.989395,303359,250447,520,1404,278,1126
USD,ttd female sx,200x200,0.126731,8,8,0,0,0,0
USD,/All Apps/Google Play/Games/Role Playing,320x50,3.293302,6137,5970,11,1,1,0
USD,Mogo DBM select video sx,970x90,2.635784,230,189,0,0,0,0
USD,mogo lydia peacecenter test,300x50,217.574618,46217,42494,29,593,21,572
USD,mogo marks branding tier 1 sx xls37852,320x50,74648.43973,19709908,18112699,20440,30724,8019,22705
USD,ttd education sx,728x90,4422.062304,1204567,1012836,717,3369,212,3157
USD,ttd entertainment sx,200x200,0.263383,17,15,0,0,0,0
USD,/All Apps/Google Play/Entertainment,320x50,325.150894,228771,219869,224,29,11,18
USD,DO NOT USE AppNexus - Collective Media,300x600,11669.51867,1279084,1011209,1534,3689,481,3208
USD,DO NOT USE Mobile - MoPub - Computers & Electronics/Software/Business & Productivity Software,300x50,0.02346,22,22,0,0,0,0
USD,mogo biz-fi sx,300x600,4425.171363,343167,307461,420,1536,185,1351
USD,mogo marks broadway sx,300x600,137.775485,11314,4933,6,39,3,36
USD,mogo marks nyt sx,728x90,4620.435987,335320,263485,141,889,50,839
USD,mogo marks stratford (canada) sx,300x600,79.362611,6293,5717,13,206,17,189
USD,mogo sports sx,320x50,4524.987731,953867,864426,699,827,134,693
USD,/All Apps/Apple App Store/Medical,728x90,1.147135,2082,2048,4,0,0,0
USD,APACTix Sitelist sx,300x250,243.211544,7310,5789,8,44,0,44
USD,Channel of Top non-US Sites for Nielsen Video Ads - DO NOT EDIT,970x66,0.701081,247,138,0,0,0,0
USD,mogo marks agg sx xsl37589,240x400,0.27811,25,16,0,0,0,0
USD,mogo marks native (sharethrough) unique can sx,300x250,18262.62615,3557528,2827115,1919,6044,489,5555
USD,mogo marks seattle sx,320x100,0.02898,7,2,0,0,0,0
USD,mogo marks ticketing sx,320x50,131.567434,19076,10414,4,52,2,50
USD,DO NOT USE Tier 1* (CHANNEL),320x100,59.825599,10880,9669,31,58,7,51
USD,DO NOT USE Tier 2* (CHANNEL),468x60,1.430465,645,311,0,0,0,0
USD,DO NOT USE Tier 3* (CHANNEL),200x200,1.74975,217,174,0,1,0,1
USD,dbm native sx (adx),970x250,1906.16592,435587,395320,574,622,119,503
USD,mogo marks branding max reach sx,Unknown,5452.056295,162953,155927,839,110,0,110
USD,mogo marks bwwpb sx,300x600,111.022907,9221,3382,2,33,2,31
USD,mogo marks native (sharethrough) unique us sx,336x280,5.988362,694,599,0,2,0,2
USD,mogo marks xsl_ks0001 sx,320x50,78406.24135,20325916,18639615,22591,31639,8719,22920
USD,DO NOT USE AppNexus - Collective Media,Unknown,5452.056295,162953,155927,839,110,0,110
USD,mogo biz-fi sx,160x600,342.563625,34245,30013,17,126,5,121
USD,mogo marks los angeles sx,970x250,3.010321,120,81,1,0,0,0
USD,mogo marks natl cat-aff-im sx,468x60,0.009001,4,1,0,0,0,0
USD,mogo marks stratford (canada) sx,160x600,0.007878,1,0,0,0,0,0
USD,sfoc pslx 2018 sx (Jun_2018_Archived),160x600,477.994152,161233,149401,105,519,63,456
USD,/All Apps/Apple App Store,300x250,3626.90285,1095381,958227,1940,73,52,21
USD,DO_NOT_USE Mobile - MoPub - Games,320x50,27.441127,21808,21423,26,3,2,1
USD,Mogo DBM select video sx,728x90,1550.053986,297116,243903,84,960,30,930
USD,RCU KPI Sitelist 1 (CPA),160x600,0.064458,2,2,0,0,0,0
USD,mogo marks branding drhbx gold sx,300x50,331.456003,42639,40299,22,867,9,858
USD,mogo mba tier 1 sx,300x250,1541.580711,123750,104621,77,599,24,575
USD,ttd gaming sx,300x250,3386.795253,1023902,780546,428,1011,117,894
USD,ttd tech sx,240x400,0.007502,1,0,0,0,0,0
USD,/All Apps/Google Play/Games/Card,300x250,114.485136,6652,5923,53,17,14,3
USD,DO NOT USE All Google Anonymous,728x90,0.524035,136,125,0,1,0,1
USD,mogo marks nyc sx,970x250,3715.61249,255667,211238,453,1059,249,810
USD,mogo marks pav kpi hx,970x90,22.723299,1053,899,1,2,0,2
USD,mogo marks perf arts branding high reach sx,250x250,0.300441,38,24,0,0,0,0
USD,provident shortlist ,160x600,4134.812164,852711,735783,479,1602,124,1478
USD,/All Apps/Google Play/Tools,300x250,89.638555,18768,15873,90,17,15,2
USD,/All Apps/Google Play/Transportation,300x600,0.371047,7,5,0,0,0,0
USD,Channel of Top non-US Sites for Nielsen Display Ads - DO NOT EDIT,300x100,2.727085,551,498,1,0,0,0
USD,DO NOT USE Tier 1* (CHANNEL),300x50,807.618186,128638,121994,102,1950,60,1890
USD,mogo marks branding elite tier sx xls37852,468x60,0.004844,2,0,0,0,0,0
USD,mogo marks bwwpb sx,160x600,1188.149368,65393,44882,51,355,22,333
USD,mogo marks native high reach tail aggregate sx,468x60,6.715499,1959,1197,0,0,0,0
USD,mogo marks video sx xsl44760 class c,468x60,1.715308,512,254,0,0,0,0
USD,mogo t1 brand sx,300x600,17492.7612,1730092,1407356,1807,5988,659,5329
USD,sfoc 2018 marks stratford premium sx,728x90,1100.938095,249727,231820,137,1915,100,1815
USD,ttd family parent sx,728x90,3598.882529,631168,482700,307,883,103,780
USD,DO NOT USE,970x250,0.006239,1,1,0,0,0,0
USD,mogo centro sx US (2014),970x90,14.425164,1953,1652,5,2,1,1
USD,mogo marks branding tier 3 sx xls37852,320x100,128.741093,27141,25086,37,68,14,54
USD,mogo marks ttd obx kitchen premium sink sx,300x600,35849.65934,4234696,3469257,3799,14306,1331,12975
USD,mogo marks wedding sx,970x90,0.991236,44,43,0,0,0,0
USD,mogo marks xsl_74205 (2p dims) sx ,300x600,10862.62199,1661770,1409412,1079,4646,448,4198
USD,ttd spanish sx,320x100,0.767258,52,48,0,0,0,0
USD,/All Apps/Apple App Store/Health & Fitness,320x50,40.643945,22014,20524,29,0,0,0
USD,RCU KPI Sitelist 1 (CPA),728x90,58.271091,3824,3652,1,16,0,16
USD,Top Performing Sites,970x250,520.536262,94135,75323,98,42,14,28
USD,mogo marks native standard reach (no) tail aggregate sx,200x200,1.12957,71,62,0,1,0,1
USD,mogo marks pav kpi sx,250x250,0.220826,18,9,0,0,0,0
USD,/All Apps/Apple App Store,970x90,0.072127,46,46,0,0,0,0
USD,Android Top Selling Free Social,300x250,43.685949,7281,2819,46,1,1,0
USD,Channel of Top US Sites for Nielsen Display Ads - DO NOT EDIT,970x250,11647.05055,1453897,1265783,2068,4072,744,3328
USD,DO NOT USE Rubicon,250x250,0.066889,10,6,0,1,0,1
USD,Diablo Blacklist ,300x250,27.768874,3412,3200,2,155,13,142
USD,mogo marks perf arts gold sx,160x600,1701.080793,102196,74696,72,524,30,494
USD,mogo marks expedia sx,160x600,162.486953,38911,32177,26,265,12,253
USD,mogo marks perf arts sx 5 rx1,970x250,296.293766,19005,11967,52,196,72,124
USD,/All Apps/Google Play/Finance,320x100,0.001064,1,0,0,0,0,0
USD,/All Apps/Google Play/Games/Strategy,300x50,0.009229,3,3,0,0,0,0
USD,Brandcast Blacklist ,160x600,775.05332,364651,325079,90,269,17,252
USD,Lynn DMAC,320x50,4.350191,1270,1211,0,3,0,3
USD,mogo biz-fi sx,728x90,6890.742483,590362,478254,259,1937,130,1807
USD,mogo marks classical music sx,336x280,0.07935,2,2,0,0,0,0
USD,ttd health wellness sx,120x600,0.039061,10,5,0,0,0,0
USD,ttd male sx,320x50,3588.77485,1538617,1424353,1027,1398,288,1110
USD,ttd sports sx,320x50,5416.410112,1089144,987388,855,1001,180,821
USD,ttd weather sx,320x100,0.07705,13,12,0,0,0,0
USD,/All Apps/Google Play/Music & Audio,160x600,0.008769,2,2,0,0,0,0
USD,DO NOT USE AppNexus - Collective Media,728x90,15075.21305,3442006,2686871,1360,7083,430,6653
USD,DO NOT USE Tier 2* (CHANNEL),300x250,12605.04461,2143818,1705080,1422,7572,362,7210
USD,PAC Singapore Rugby sx,300x50,0.006383,3,3,0,0,0,0
USD,mogo marks bwwpb sx,728x90,377.955051,27584,13679,28,128,14,114
USD,mogo marks lal (purchase) platinum sx,200x200,0.25833,23,17,0,0,0,0
USD,mogo marks pav kpi sx 2,320x100,9.376122,526,349,0,4,0,4
USD,mogo marks perf arts branding high reach sx,300x600,732.097121,45077,33657,55,292,37,255
USD,mogo marks stratford (canada) sx,728x90,13.150528,2233,2080,4,23,3,20
USD,mogo marks toronto sx,300x600,304.094025,31110,27336,68,287,38,249
USD,sfoc pslx 2018 sx (Jun_2018_Archived),320x50,2615.841218,943804,899019,960,4309,564,3745
USD,DO NOT USE Mobile - MoPub - Arts & Entertainment/Music & Audio,300x250,176.014529,104738,103299,83,3,3,0
USD,Mogo DBM premium video sx,970x90,76.159599,4802,4065,4,7,0,7
USD,mogo marks branding drhbx gold sx,320x50,20402.23962,2998340,2753910,6055,9601,3751,5850
USD,mogo marks branding drhbx platinum sx,300x600,2410.287431,161536,141878,189,1569,94,1475
USD,mogo marks video branding extended reach tail aggregate sx,300x600,27529.33377,3389718,2835895,3263,10900,1206,9694
USD,mogo sf local sx,970x90,2.509667,203,146,0,0,0,0
USD,pac esports sx,120x600,0.111087,43,41,0,0,0,0
USD,ttd male sx,320x100,6.27391,1359,1201,5,1,1,0
USD,ttd sports sx,320x100,4.388494,483,448,2,9,0,9
USD,/All Apps/Apple App Store/Health & Fitness,320x100,0.010178,2,1,0,0,0,0
USD,/All Apps/Apple App Store/Social Networking,300x250,29.102736,9143,7577,21,1,1,0
USD,/All Apps/Apple App Store/Utilities,160x600,0.020936,2,1,0,0,0,0
USD,Channel of Top Global Sites for Nielsen Display Ads - DO NOT EDIT,728x90,74136.71295,15189047,12452718,7732,38330,2441,35889
USD,Channel of Top non-US Sites for Nielsen Video Ads - DO NOT EDIT,970x250,7860.169182,972912,855859,1382,2819,445,2374
USD,DO NOT USE Tier 1* (CHANNEL),320x50,44420.30954,10347599,9631837,14406,17500,5891,11609
USD,mogo marks branding comp rate silver video sx,300x250,68202.61939,15723085,12879275,7351,21020,2120,18900
USD,mogo marks branding drhbx silver sx,300x250,78367.85148,11924421,9008713,8095,33748,2694,31054
USD,mogo marks lal branding (All) gold sx,200x200,0.801886,66,52,0,0,0,0
USD,mogo marks rt+ob lt_lq black sx  ,300x600,0.210249,11,8,0,0,0,0
USD,/All Apps/Apple App Store/Games/Strategy,300x250,0.248836,83,82,1,0,0,0
USD,mogo marks lal (purchase) silver sx,468x60,2.745884,784,391,0,0,0,0
USD,mogo marks pav kpi sx 3,160x600,144.067586,33986,31706,22,49,7,42
USD,mogo marks xsl_ks20780 sx,250x250,92.73034,11721,9647,4,17,0,17
USD,ttd spanish sx,336x280,0.024179,5,4,0,0,0,0
USD,/All Apps/Apple App Store/Travel,300x600,0.07107,3,2,0,0,0,0
USD,Android Top Selling Free Entertainment,300x600,162.719033,5540,4803,241,117,97,20
USD,mogo marks sacramento sx,300x50,6.354445,1037,973,2,17,6,11
USD,/All Apps/Google Play/Games/Arcade,728x90,1.103189,921,892,4,0,0,0
USD,/All Apps/Google Play/Games/Puzzle,300x600,93.191472,4587,4001,123,33,33,0
USD,DO NOT USE Tier 2* (CHANNEL),320x51,0.8361,20,19,0,0,0,0
USD,Lynn Undergrad,336x280,0.882622,18,16,0,0,0,0
USD,mogo marks lal branding (All) platinum sx,468x60,0.057255,23,17,0,0,0,0
USD,mogo marks native medium reach tail aggregate sx,300x250,85469.50504,17141239,13396045,10005,34852,2990,31862
USD,mogo marks pav kpi sx 2,970x66,0.044344,8,4,0,0,0,0
USD,mogo marks perf arts sx 11,970x90,0.442692,15,12,0,0,0,0
USD,mogo marks perf arts sx 5 rx1,970x66,0.004991,1,0,0,0,0,0
USD,mogo marks perf arts sx 7,250x250,0.009307,5,0,0,0,0,0
USD,ttd travel sx,160x600,1146.492659,156788,106746,108,836,43,793
USD,/All Apps/Google Play/Games/Sports,320x50,5.634142,5517,5181,25,2,2,0
USD,/All Apps/Google Play/Games/Word,300x600,127.117087,4961,4479,49,22,19,3
USD,DO NOT USE Tier 3* (CHANNEL) (2),300x600,881.134625,145886,116631,127,550,59,491
USD,Greg's GG KPI + relevant sites list,160x600,4.955413,426,368,0,1,0,1
USD,Mogo DBM basic video sx,320x50,3383.990322,992159,926768,1312,1007,355,652
USD,Performing Arts Fort Worth Top sx,728x90,21.293552,2279,1834,2,5,0,5
USD,mogo marks branding comp rate gold video sx,250x250,17.951178,2343,1852,1,2,0,2
USD,mogo marks lal branding (All) platinum sx,970x66,0.011732,9,0,0,0,0,0
USD,mogo marks natl elite cat-aff-im sx,320x100,8.765242,445,292,0,4,0,4
USD,mogo marks perf arts gold sx,970x90,0.519304,25,22,0,0,0,0
USD,ttd news sx,320x100,18.045363,4850,4362,25,25,8,17
USD,/All Apps/Apple App Store/Games,300x250,304.566744,32669,29486,618,25,23,2
USD,/All Apps/Apple App Store/Games/Simulation,300x250,0.656979,92,46,1,0,0,0
USD,DO NOT USE Invite December Brand Safe List,160x600,9861.385964,2579128,2318552,1224,3870,367,3503
USD,DO NOT USE Mobile - MoPub - Jobs & Education,320x50,2.503651,5631,5593,7,0,0,0
USD,mogo black sx,300x50,129.447604,34078,32064,16,217,10,207
USD,mogo marks expedia sx,970x90,0.024158,2,2,0,0,0,0
USD,mogo marks native sx xsl1045 class c,300x600,9588.602024,1332217,1062769,954,4295,307,3988
USD,mogo marks sports sx,468x60,0.056741,7,5,0,0,0,0
USD,ttd auto sx,320x50,1649.275726,94724,86398,56,370,6,364
USD,ttd finance sx,300x600,4564.785647,368236,327681,442,1567,189,1378
USD,/All Apps/Apple App Store/Food & Drink,300x50,1.260743,281,277,2,0,0,0
USD,Android Top Selling Free Social,728x90,5.645613,6550,6079,22,1,1,0
USD,DO NOT USE Tier 2,250x250,7.854839,784,591,0,3,0,3
USD,mogo education sx,120x600,0.056483,18,18,0,0,0,0
USD,mogo marks branding max reach sx,200x200,5.431011,743,545,0,2,0,2
USD,mogo marks lal (purchase) silver sx,970x66,0.883345,248,139,0,0,0,0
USD,mogo marks lal branding (All) gold sx,300x100,0.380564,68,62,0,0,0,0
USD,mogo marks native (sharethrough) unique us sx,160x600,1569.928982,323791,270597,211,594,58,536
USD,mogo music sx,300x50,11.63695,1336,1250,2,19,1,18
USD,DO NOT USE Tier 2* (CHANNEL),970x250,423.617033,36327,28933,82,95,10,85
USD,dbm video sx,300x600,18700.68735,2055333,1729876,1933,6828,707,6121
USD,mogo marks branding tier 1 sx xls37852,320x51,0.8361,20,19,0,0,0,0
USD,mogo marks email sx,250x250,2.35253,450,370,0,2,0,2
USD,mogo marks trip advisor sx,728x90,290.663238,4972,3954,4,84,1,83
USD,mogo music sx,120x600,0.017775,1,1,0,0,0,0
USD,ttd health wellness sx,200x200,0.097772,6,3,0,0,0,0
USD,/All Apps/Apple App Store/Finance,320x100,0.016215,6,6,0,0,0,0
USD,/All Apps/Google Play/Health & Fitness,300x600,3.147485,177,163,2,0,0,0
USD,Channel of Top Global Sites for Nielsen Video Ads - DO NOT EDIT,320x50,89056.38568,26067189,24384602,26993,32687,9591,23096
USD,DO NOT USE Tier 3 (2),970x66,0.000138,1,0,0,0,0,0
USD,DO_NOT_USE Bid Manager reportable sites channel (Soon to be deprecated and please exclude channel: Non-reportable sites and apps),300x250,177869.1963,37036350,29134338,22641,70166,6113,64053
USD,Duxiana - KPI sx,970x250,270.899112,37042,30713,102,3,1,2
USD,central city  opera black sx,728x90,0.239516,6,6,0,0,0,0
USD,mogo education sx,300x50,154.302769,47830,44745,13,607,7,600
USD,mogo marks t1 brand sx trim,728x90,19206.69521,3150245,2256201,2163,6815,480,6335
USD,mogo marks xsl_ks0001 sx,320x51,0.8361,20,19,0,0,0,0
USD,stratford black OB sx,300x600,0.046585,8,7,0,0,0,0
USD,ttd family parent sx,300x100,0.02763,5,3,0,0,0,0
USD,/All Apps/Google Play/Education,320x100,0.001725,3,2,0,0,0,0
USD,/All Apps/Google Play/Games/Action,336x280,0.03653,12,9,0,0,0,0
USD,/All Apps/Google Play/Games/Educational,300x50,0.01963,15,14,0,0,0,0
USD,/All Apps/Google Play/Games/Sports,300x600,1.473938,77,73,6,0,0,0
USD,mogo biz-fi sx,970x250,4618.198184,378310,325372,674,1390,311,1079
USD,mogo marks branding comp rate gold video sx,336x280,14.200937,1169,1054,0,1,0,1
USD,mogo marks broadway sx,728x90,1579.085189,160148,119695,79,388,32,356
USD,mogo marks native (sharethrough) unique can sx,320x100,35.689518,3813,3449,7,20,2,18
USD,mogo marks perf arts platinum sx,728x90,1055.805344,85876,53421,54,348,24,324
USD,mogo marks stratford (canada) sx,970x250,14.800556,1056,761,0,31,0,31
USD,Channel of Top US Sites for Nielsen Display Ads - DO NOT EDIT,200x200,6.562437,842,586,0,2,0,2
USD,South Coast Rep Perf Arts 5 black sx,160x600,0.270193,26,19,0,0,0,0
USD,mogo marks bwwpb sx,970x250,214.980022,12142,6830,26,137,62,75
USD,mogo marks detroit sx,320x50,1190.558312,111493,107221,352,354,185,169
USD,mogo marks trip advisor sx,300x250,629.516123,11215,10083,7,297,6,291
USD,/All Apps/Apple App Store/Games/Board,300x50,17.076484,1762,1723,11,0,0,0
USD,/All Apps/Google Play,160x600,6.367575,1062,985,12,5,4,1
USD,DO NOT USE Mobile - MoPub - Jobs & Education,300x600,0.014404,1,1,0,0,0,0
USD,DO NOT USE Mobile - MoPub - Travel,300x50,0.02392,5,5,0,0,0,0
USD,DO NOT USE Tier 2,336x280,9.016891,1450,1242,1,7,0,7
USD,DO NOT USE Tier 2* (CHANNEL),120x600,0.150018,134,81,0,0,0,0
USD,DO NOT USE Tier 3* (CHANNEL) (2),468x60,0.529298,233,147,0,0,0,0
USD,mogo mba tier 1 sx,970x90,0.911926,47,40,0,0,0,0
USD,provident shortlist ,970x250,8394.356017,803984,692462,1393,3025,538,2487
USD,sfoc kpi sx (acquisition 2019),160x600,9.163059,881,775,0,38,0,38
USD,ttd auto sx,300x600,427.902221,20113,17754,25,86,7,79
USD,ttd gaming sx,970x90,6.68173,778,708,0,0,0,0
USD,Android Movers and Shakers,160x600,1.052192,26,25,0,0,0,0
USD,CST KPI List,320x50,3.438512,4884,3422,1,1,1,0
USD,CST KPI List,728x90,0.907862,460,319,0,0,0,0
USD,Channel of Top Global Sites for Nielsen Video Ads - DO NOT EDIT,300x600,38655.87694,4708912,3970895,4395,16270,1632,14638
USD,DO NOT USE AppNexus - Collective Media,970x250,2041.354893,379012,339275,522,759,189,570
USD,Mogo DBM basic video sx,300x600,412.013387,97513,68519,67,185,16,169
USD,central city  opera black sx,300x250,0.56373,21,18,0,0,0,0
USD,dbm video sx,468x60,0.049493,10,6,0,0,0,0
USD,mogo marks t1 brand sx trim,300x250,45171.09325,8501297,6430039,5792,16899,1798,15101
USD,mogo marks video branding extended reach tail aggregate sx,970x66,0.348931,302,28,0,0,0,0
USD,mogo marks xsl_800p sx,160x600,29163.85041,7459315,6621543,3419,16392,1131,15261
USD,DO NOT USE Invite December Brand Safe List,250x250,40.537102,4311,3569,1,9,0,9
USD,RCU KPI Sitelist 1 (CPA),970x250,1.75066,69,65,0,0,0,0
USD,mogo marks branding max reach sx,120x600,9.539376,2186,1632,1,0,0,0
USD,mogo marks native sx xsl1045 class b,728x90,6106.919968,1412703,1156967,1078,3031,127,2904
USD,mogo marks native sx xsl1045 class c,468x60,1.996867,540,342,0,0,0,0
USD,mogo marks playbill sx x3e,728x90,191.365945,20073,8671,18,105,13,92
USD,sfoc marks lal custom sx,320x50,0.015027,12,10,0,0,0,0
USD,ttd kids sx,250x250,1.448034,169,137,0,0,0,0
USD,DO NOT USE Tier 3* (CHANNEL) (2),336x280,14.431609,1231,1084,0,7,0,7
USD,mogo marks nyc sx,200x200,0.014553,1,0,0,0,0,0
USD,mogo marks outbound kpi sx x1a,300x600,2566.765837,115803,95880,332,560,99,461
USD,mogo universal rt+ob black sx,300x600,5.753214,1138,949,3,12,3,9
USD,ttd family parent sx,970x250,448.535383,36630,31625,72,55,15,40
USD,Android Top Selling Free Business,320x100,0.112439,68,50,0,0,0,0
USD,mogo marks branding max reach sx,240x400,0.283233,26,17,0,0,0,0
USD,mogo marks native standard reach (no) tail aggregate sx,320x100,159.328215,24906,23394,56,72,24,48
USD,mogo marks natl cat-aff-im sx,300x100,0.153683,27,20,0,0,0,0
USD,mogo marks xsl_ks0001 sx,970x90,262.703885,20619,17710,22,19,1,18
USD,mogo mba tier 2 sx,320x50,5671.900702,1342449,1274364,1345,2015,444,1571
USD,sfoc 2018 marks stratford premium sx,970x250,337.659804,47309,43315,83,357,72,285
USD,sfoc marks lal custom sx,160x600,24.816652,14837,14461,4,15,2,13
USD,ttd auto sx,250x250,0.699651,50,41,0,0,0,0
USD,/All Apps/Google Play/Medical,320x50,0.772337,647,617,0,0,0,0
USD,CST KPI List,160x600,9.311556,470,327,3,6,1,5
USD,DO NOT USE OAM UK,300x600,796.029458,98104,86913,140,233,39,194
USD,dbm video sx,336x280,11.605855,958,855,0,1,0,1
USD,mogo marks broadway sx,160x600,1617.685236,94419,69332,71,524,27,497
USD,mogo marks hq100p sx,320x100,130.411067,32308,30147,39,78,13,65
USD,mogo marks lal branding (All) gold sx,728x90,26839.89785,3198719,2535770,1800,17681,611,17070
USD,mogo marks native sx xsl1045 class c,336x280,14.439618,1416,1250,0,3,0,3
USD,pac esports sx,300x250,4931.814849,1698766,1367563,341,2259,69,2190
USD,ttd sports sx,900x90,0.001275,1,1,0,0,0,0
USD,Brandcast Blacklist ,468x60,0.020142,17,0,0,0,0,0
USD,Mogo DBM select video sx,970x250,54.048011,3377,2680,9,17,2,15
USD,Mogo dating sx,320x50,0.312216,26,21,0,0,0,0
USD,Portland Center Stage KPI sx,728x90,13.106124,1641,1402,1,5,2,3
USD,mogo marks native high reach tail aggregate sx,300x100,1.980468,395,342,1,0,0,0
USD,mogo marks native sx xsl1045 class b,160x600,426.558062,61321,47231,31,255,4,251
USD,mogo marks xsl66781 sx,320x100,27.03676,7247,6759,10,18,3,15
USD,ttd beauty sx,320x50,39.085484,6468,6088,4,3,0,3
USD,ttd food sx,970x90,16.698513,2311,2010,2,3,0,3
USD,Channel of Top Global Sites for Nielsen Video Ads - DO NOT EDIT,250x250,79.378008,10749,8982,8,9,0,9
USD,Mogo DBM basic video sx,250x250,1.833336,227,187,0,0,0,0
USD,at atlanta sx,728x90,25.148771,3224,2842,2,21,1,20
USD,mogo marks bay area sx,320x100,0.022454,3,3,0,0,0,0
USD,mogo marks branding tier 2 sx xls37852,320x100,188.811043,40575,37736,62,110,21,89
USD,mogo marks perf arts sx 2,970x90,15.280101,743,651,1,2,0,2
USD,sfoc hqcat black hx,300x600,77.946117,3808,3405,5,57,5,52
USD,ttd finance sx,336x280,1.507609,65,56,0,0,0,0
USD,/All Apps,320x100,1.881131,913,761,0,0,0,0
USD,/All Apps/Apple App Store/Medical,300x250,0.424042,136,107,0,0,0,0
USD,/All Apps/Google Play/Games/Role Playing,300x600,0.00138,1,1,0,0,0,0
USD,/All Apps/Google Play/Social,160x600,0.048449,2,2,0,0,0,0
USD,mogo marks ticketing sx,300x600,0.182387,5,4,0,0,0,0
USD,mogo marks video sx xsl44760 class b,320x50,2394.344009,535912,468419,753,884,273,611
USD,ttd entertainment sx,300x50,273.345614,62000,59030,29,668,37,631
USD,/All Apps/Google Play/Games/Casino,300x50,0.039149,10,9,0,0,0,0
USD,Channel of Top US Sites for Nielsen Video Ads - DO NOT EDIT,970x66,1.25183,702,171,0,0,0,0
USD,mogo marks bwwpb sx,468x60,0.004844,2,0,0,0,0,0
USD,mogo marks lal (purchase) silver sx,200x200,1.054281,129,75,0,1,0,1
USD,mogo marks xsl_ks0001 sx,300x600,36625.39573,4321586,3540890,3907,14831,1388,13443
USD,mogo marks xsl_ks20780 sx,970x90,351.67905,27572,23761,23,31,1,30
USD,mogo sports sx,300x600,975.223765,117583,100761,108,200,33,167
USD,pac esports sx,250x250,13.608103,2348,1981,0,1,0,1
USD,ttd education sx,300x250,4082.30612,959137,780575,561,2895,193,2702
USD,zt local austin sx,728x90,6.604369,672,516,1,8,2,6
USD,/All Apps/Apple App Store/Games/Action,728x90,3.019893,2369,2318,6,0,0,0
USD,/All Apps/Apple App Store/News,320x100,0.001811,4,4,0,0,0,0
USD,Channel of Top Global Sites for Nielsen Display Ads - DO NOT EDIT,320x51,0.837271,21,20,0,0,0,0
USD,dbm native sx (adx),120x600,0.163752,54,46,0,0,0,0
USD,mogo marks branding tier 1 sx xls37852,300x600,36262.1189,4330705,3600081,3860,16855,1483,15372
USD,mogo marks lal branding (All) platinum sx,200x200,0.470789,38,31,0,0,0,0
USD,mogo marks shakespeare sx,320x50,48.056477,6013,5024,5,10,2,8
USD,mogo marks xsl_74205 sx ,320x100,25.496135,6756,6301,10,18,3,15
USD,sfoc marks kpi sx (062018),728x90,177.96443,38141,36254,19,438,18,420
USD,/All Apps/Google Play/Books & Reference,336x280,0.029986,2,2,0,0,0,0
USD,DO_NOT_USE Bid Manager reportable sites channel (Soon to be deprecated and please exclude channel: Non-reportable sites and apps),970x66,0.858286,496,63,0,0,0,0
USD,Portland Center Stage Perf Arts 5 black sx,728x90,0.008625,1,1,0,0,0,0
USD,mogo biz-fi sx,468x60,0.032293,12,10,0,0,0,0
USD,mogo marks lal (purchase) platinum sx,300x100,0.007841,1,1,0,0,0,0
USD,mogo marks native sx xsl1045 class a,336x280,0.970143,19,16,0,0,0,0
USD,mogo marks native sx xsl1045 class c,970x66,0.042525,11,6,0,0,0,0
USD,mogo marks wine sx,970x250,0.124979,15,12,0,0,0,0
USD,mogo mba tier 1 sx,250x250,0.010476,1,1,0,0,0,0
USD,provident shortlist ,468x60,2.028307,649,378,0,0,0,0
USD,/All Apps/Apple App Store/Music,320x50,172.288958,184322,168545,262,4,4,0
USD,/All Apps/Google Play/Entertainment,300x600,7.811377,580,531,14,4,4,0
USD,Duxiana- Bad Site List(Allan) ,320x50,377.023429,93044,88282,79,6,0,6
USD,Stratford Black RT SX,728x90,2.639149,637,589,1,23,0,23
USD,magic theatre top performing sx,970x250,47.775784,4240,2832,6,15,4,11
USD,mogo marks high intenders sx,728x90,1480.061278,201848,163270,90,715,38,677
USD,mogo marks nyt sx,300x250,4924.231027,842673,669592,975,1307,293,1014
USD,ttd female sx,300x50,90.129125,17409,16530,8,206,5,201
USD,/All Apps/Google Play/Games/Arcade,160x600,0.044246,2,1,1,1,1,0
USD,Android Top Selling Free Weather,300x600,60.432977,3532,3309,145,152,137,15
USD,DO NOT USE AppNexus - Collective Media,300x100,0.197913,30,21,0,0,0,0
USD,DO_NOT_USE Mobile - MoPub - Games,970x250,0.107114,1,1,0,0,0,0
USD,Mogo DBM select video sx,320x100,0.057787,8,8,0,0,0,0
USD,Triad Stage Perf Arts black sx,300x600,0.064862,9,6,0,0,0,0
USD,mogo marks branding comp rate silver video sx,250x250,23.352106,3104,2496,1,5,0,5
USD,mogo marks branding drhbx silver sx,250x250,26.33765,2569,2119,3,7,0,7
USD,mogo marks detroit sx,160x600,0.01495,3,2,0,0,0,0
USD,mogo marks native medium reach tail aggregate sx,250x250,41.310749,5124,4153,4,8,0,8
USD,mogo marks travel sx,970x90,2.037963,109,89,0,0,0,0
USD,mogo mba tier 2 sx,728x90,6596.118329,548997,444161,243,1667,72,1595
USD,pac motorsports sx,970x90,7.702169,817,614,1,0,0,0
USD,mogo marks coupon sx,300x600,201.246883,9592,7994,13,34,9,25
USD,mogo perf arts sx,300x600,493.151002,46873,31475,53,162,32,130
USD,ttd family parent sx,320x100,18.334211,2991,2852,3,3,1,2
USD,BBB black sx,300x250,0.113348,19,18,0,0,0,0
USD,DO NOT USE fgu test public channel,336x280,0.012132,1,1,0,0,0,0
USD,mogo marks branding comp rate platinum video sx,970x90,36.113433,1972,1679,4,3,0,3
USD,mogo marks branding tier 3 sx xls37852,970x66,0.095855,27,9,0,0,0,0
USD,mogo marks high intenders sx,200x200,0.016727,1,0,0,0,0,0
USD,/All Apps/Google Play/Games/Adventure,300x50,0.022943,6,6,0,0,0,0
USD,/All Apps/Google Play/Medical,728x90,0.004284,16,16,0,0,0,0
USD,DO NOT USE Tier 1,250x250,32.022765,3717,3064,2,5,0,5
USD,mogo marks branding increased reach sx,320x51,0.837271,21,20,0,0,0,0
USD,mogo marks lal branding (All) silver sx,300x600,28971.00633,2562881,2217194,2574,15358,1032,14326
USD,mogo universal rt+ob black sx,300x250,5.640381,1185,668,4,12,3,9
USD,ttd education sx,120x600,0.777597,108,84,0,0,0,0
USD,ttd sports sx,160x600,570.154883,95871,77092,54,129,4,125
USD,Mogo dating sx,728x90,0.074807,8,8,0,0,0,0
USD,mogo marks outbound kpi sx x1a,300x250,11033.15078,1362143,1023325,1471,3774,501,3273
USD,ttd beauty sx,728x90,102.724024,23799,19602,4,30,1,29
USD,Channel of Top Global Sites for Nielsen Display Ads - DO NOT EDIT,300x50,3175.282903,649643,616995,281,8287,209,8078
USD,Performing Arts Fort Worth Perf Arts 5 black sx,728x90,1.129309,191,146,0,2,0,2
USD,mogo marks branding drhbx platinum sx,300x100,0.094447,16,15,0,0,0,0
USD,mogo marks hq100p sx,728x90,24191.29448,4189953,3288023,2473,10120,576,9544
USD,mogo marks video branding extended reach tail aggregate sx,300x100,0.824328,184,170,0,0,0,0
USD,mogo marks xsl_74205 sx ,200x200,0.018275,2,1,0,0,0,0
USD,mogo sf local sx,970x66,0.035616,185,1,0,0,0,0
USD,sfoc 2018 marks stratford premium sx,320x50,1965.748224,642348,611886,599,3143,363,2780
USD,/All Apps/Google Play/Tools,300x600,59.258596,3633,3043,49,11,11,0
USD,Mogo DBM select video sx,320x50,942.501485,226122,203559,260,393,64,329
USD,Portland Center Stage KPI sx,320x50,33.833789,3821,3660,5,9,0,9
USD,mogo marks cincinnati sx,320x100,0.012564,14,7,0,0,0,0
USD,mogo marks xsl66781 sx,728x90,9946.90568,1384373,1002899,534,3757,260,3497
USD,mogo sports sx,970x66,0.853532,242,130,0,0,0,0
USD,/All Apps/Apple App Store/Games/Dice,300x250,0.220311,10,7,0,0,0,0
USD,/All Apps/Google Play/Productivity,728x90,1.586487,1667,1644,6,0,0,0
USD,DO NOT USE Spanish Language Sites,200x200,0.009995,1,1,0,0,0,0
USD,DO NOT USE Tier 2* (CHANNEL),250x250,7.854839,784,591,0,3,0,3
USD,DO NOT USE Tier 3* (CHANNEL),970x90,147.189078,11847,10387,12,12,0,12
USD,mogo marks kpi achievers sx,200x200,0.014553,1,0,0,0,0,0
USD,mogo marks lal branding (All) gold sx,320x50,29640.98456,4178865,3815715,7612,13289,4249,9040
USD,mogo marks native (sharethrough) unique can sx,160x600,1240.226287,293319,248068,189,372,54,318
USD,ttd gaming sx,300x600,1301.363309,273254,234571,313,492,136,356
USD,Android Top Selling Free Business,728x90,0.018058,18,16,0,0,0,0
USD,mogo marks branding increased reach sx,300x250,170628.0354,36184908,28576123,18092,68314,5331,62983
USD,mogo marks disney sx,468x60,0.187436,81,58,0,0,0,0
USD,mogo marks video branding medium reach tail aggregate sx,300x100,2.368311,523,476,1,0,0,0
USD,ocfta local madison sx,970x250,1.193404,68,57,0,0,0,0
USD,sfoc rtx kpi sx,300x250,332.176684,86056,77851,54,639,48,591
USD,ttd family parent sx,320x50,1762.869419,823682,777898,282,738,86,652
USD,ttd spanish sx,970x250,4.861871,1062,815,3,0,0,0
USD,/All Apps/Apple App Store,300x600,1726.047823,109962,86728,6578,954,882,72
USD,/All Apps/Apple App Store/Newsstand/News & Politics,970x90,0.008705,5,5,0,0,0,0
USD,/All Apps/Google Play/Games/Card,300x600,113.266567,4058,3760,45,10,9,1
USD,/All Apps/Google Play/Games/Trivia,300x250,4.756279,382,332,4,0,0,0
USD,APACTix Sitelist sx,160x600,5.210368,132,114,1,1,0,1
USD,DO NOT USE All Google Anonymous,320x50,0.859548,331,323,0,0,0,0
USD,mogo marks branding tier 2 sx xls37852,728x90,36920.47619,5880471,4437663,2748,20979,992,19987
USD,mogo marks jazz & blues sx,468x60,0.031694,35,30,0,0,0,0
USD,mogo mba tier 1 sx,300x600,1408.859783,67294,59168,88,618,37,581
USD,/All Apps/Google Play/Weather,300x50,27.457181,4717,4400,5,2,0,2
USD,mogo marks branding comp rate silver video sx,970x90,87.977212,5354,4478,4,5,0,5
USD,mogo marks branding drhbx silver sx,970x90,186.072309,13393,11483,14,17,1,16
USD,mogo marks hq100p sx,468x60,0.299834,60,42,0,0,0,0
USD,mogo marks kpi mdx sx xls9297,728x90,7918.933776,826178,577190,326,2585,129,2456
USD,/All Apps/Google Play/Games/Board,970x250,0.045077,33,32,0,0,0,0
USD,DO NOT USE Mobile - MoPub - News/Weather,320x50,0.012851,5,4,0,0,0,0
USD,mogo marks branding tier 2 sx xls37852,468x60,1.238195,424,330,0,0,0,0
USD,mogo marks branding tier 3 sx xls37852,300x100,0.174572,40,36,0,0,0,0
USD,mogo marks pav kpi hx,300x600,6374.328786,1237657,947642,600,2948,310,2638
USD,/All Apps/Google Play/News & Magazines,970x250,0.001733,5,5,0,0,0,0
USD,Android Top Selling Free Photography,320x100,0.000058,1,1,0,0,0,0
USD,DO NOT USE Mobile - MoPub - Travel,320x50,0.098481,169,163,0,0,0,0
USD,DO NOT USE Rubicon,300x50,15.926399,1784,1692,0,10,0,10
USD,co top 41 converting,728x90,33.987189,3130,2484,1,10,0,10
USD,mogo marks dallas sx,300x600,291.590441,19015,15416,20,58,10,48
USD,mogo marks native medium reach tail aggregate sx,970x90,224.482443,17964,15322,12,20,0,20
USD,mogo marks pav kpi sx,300x50,3.522804,202,193,2,15,2,13
USD,ttd kids sx,300x50,123.705388,40760,38012,9,507,7,500
USD,/All Apps/Google Play/Sports,300x250,33.74044,11614,8398,20,1,1,0
USD,Android Top Selling Free News and Magazines,160x600,0.034529,2,1,0,0,0,0
USD,Provident High CTR List ,300x600,169.455167,13681,12754,10,2,0,2
USD,kid safe sx,970x90,33.684589,2006,1717,4,0,0,0
USD,mogo canada t1 sx,120x600,0.051155,8,5,0,0,0,0
USD,mogo marks native (sharethrough) unique can sx,336x280,5.954664,676,585,0,2,0,2
USD,mogo marks nyc sx,160x600,1209.374328,67595,47006,47,347,21,326
USD,mogo marks wedding sx,300x600,71.26978,2846,2597,0,36,6,30
USD,mogo marks xsl66781 sx,468x60,0.006997,3,1,0,0,0,0
USD,ttd news sx,320x50,27888.24426,5701011,5286335,10522,10391,5178,5213
USD,tz - Local Seattle sx,300x250,37.686577,8980,7303,6,16,0,16
USD,/All Apps/Apple App Store/Newsstand,300x600,104.244439,22040,16700,68,1,0,1
USD,/All Apps/Google Play/Personalization,320x100,0.004025,5,3,0,0,0,0
USD,Android Top Selling Free Sports,300x250,26.088721,10559,7585,16,1,1,0
USD,DO NOT USE Microsoft Bin (001),728x90,515.231504,155962,132721,733,154,13,141
USD,DO NOT USE Tier 3 (2),320x100,17.068311,1353,1202,3,9,0,9
USD,mogo black sx,300x600,841.016633,106587,92651,107,377,50,327
USD,mogo centro sx US (2014),300x250,10133.53905,1834847,1299904,1175,3240,364,2876
USD,mogo marks los angeles sx,160x600,34.622246,1762,1663,5,10,3,7
USD,mogo marks pav kpi sx 3,970x250,3656.534437,254061,208744,443,1045,191,854
USD,sfoc marks kpi sx (062018),160x600,2.778728,197,174,0,1,0,1
USD,ttd education sx,250x250,7.534624,786,662,0,1,0,1
USD,ttd travel sx,970x250,607.874197,35451,28725,108,191,42,149
USD,/All Apps/Google Play/Games/Puzzle,300x50,15.584406,2400,2356,8,0,0,0
USD,DO NOT USE Tier 2* (CHANNEL),160x600,1327.787855,257102,219341,196,894,46,848
USD,maryland-dc sx,970x250,311.109943,50426,39530,49,30,7,23
USD,mogo marks agg sx xsl37589,120x600,9.29426,1942,1596,1,0,0,0
USD,mogo marks branding drhbx silver sx,300x50,1506.602943,204164,193770,116,4472,83,4389
USD,mogo marks branding max reach sx,900x90,0.001275,1,1,0,0,0,0
USD,mogo marks video branding medium reach tail aggregate sx,120x600,5.099699,1116,880,0,0,0,0
USD,/All Apps/Apple App Store,320x50,3936.722674,2158631,2022169,3433,92,48,44
USD,/All Apps/Google Play/Games/Card,320x50,32.164265,29504,27246,107,13,12,1
USD,/All Apps/Google Play/Games/Trivia,728x90,1.74054,1147,1130,0,0,0,0
USD,mogo marks jazz & blues sx,300x600,42.405388,6440,5301,5,27,1,26
USD,mogo marks native sx xsl1045 class b,970x66,0.00239,2,1,0,0,0,0
USD,mogo mba tier 1 sx,320x50,532.946277,172112,151799,94,251,55,196
USD,/All Apps/Apple App Store/Newsstand/Regional News,970x250,0.064745,4,2,0,0,0,0
USD,mogo marks lal (purchase) platinum sx,970x90,13.426802,521,453,3,1,0,1
USD,mogo marks video sx xsl44760 class b,468x60,0.137095,98,25,0,0,0,0
USD,/All Apps/Apple App Store/Productivity,300x600,0.29642,40,37,0,0,0,0
USD,/All Apps/Google Play/Tools,320x50,83.885944,53789,51515,122,22,14,8
USD,5a local sx seattle,300x250,30.975201,5758,4759,0,7,0,7
USD,kid safe sx,120x600,0.491161,53,40,0,0,0,0
USD,mogo financial services kpi sx,300x600,5921.419414,1033175,844612,518,2662,208,2454
USD,mogo marks branding drhbx gold sx,200x200,0.49788,36,26,0,0,0,0
USD,mogo marks branding drhbx platinum sx,300x50,69.12031,6926,6494,3,117,0,117
USD,sfoc rtx kpi sx,728x90,20.74771,3280,2882,2,23,0,23
USD,/All Apps/Apple App Store/Games/Dice,728x90,19.632655,9060,9001,27,2,2,0
USD,/All Apps/Google Play/Libraries & Demo,300x250,0.001869,1,1,0,0,0,0
USD,/All Apps/Google Play/Lifestyle,300x250,22.056309,3971,3408,8,1,0,1
USD,DO NOT USE Tier 1* (CHANNEL),200x200,0.534743,76,32,0,1,0,1
USD,mogo marks ballet sx,300x250,44.594296,5403,4103,5,11,2,9
USD,mogo marks branding drhbx platinum sx,120x600,0.187812,35,26,0,0,0,0
USD,mogo marks natl elite cat-aff-im sx,160x600,1196.249273,66668,46002,51,359,22,337
USD,mogo marks perf arts gold sx,300x600,229.384073,17476,9511,22,74,16,58
USD,mogo marks xsl_ks20780 sx,240x400,0.240766,19,15,0,0,0,0
USD,ttd gaming sx,320x50,2262.658126,763392,703513,863,873,258,615
USD,/All Apps/Apple App Store/Games/Adventure,320x50,2.159012,4336,4303,6,0,0,0
USD,/All Apps/Google Play/Games/Action,300x600,58.591792,1308,1134,146,98,87,11
USD,Triad Stage Perf Arts black sx,300x250,0.644318,123,96,0,0,0,0
USD,mogo marks branding comp rate gold video sx,300x600,14831.43718,1725567,1404738,1888,4770,693,4077
USD,mogo marks xsl_74205 sx ,970x66,0.049335,9,4,0,0,0,0
USD,pac esports sx,240x400,0.021704,1,1,0,0,0,0
USD,sfoc hqcat black hx,300x250,77.004269,5620,4916,7,165,6,159
USD,Duxiana- Bad Site List(Allan) ,970x250,55.143135,7738,5533,46,0,0,0
USD,mogo marks coupon sx,300x250,144.105566,10480,7805,9,62,6,56
USD,Android Top Selling Free Weather,300x250,42.006495,6504,4865,46,13,9,4
USD,BBB perf arts 5 black sx,160x600,6.534562,846,803,0,7,0,7
USD,DO NOT USE Mobile - MoPub - Computers & Electronics/Software/Multimedia Software/Audio & Music Software,320x50,20.312376,42534,42388,59,0,0,0
USD,mogo marks branding tier 1 sx xls37852,300x50,1661.167807,279350,263930,144,4708,109,4599
USD,mogo marks email sx,300x600,802.945171,58415,45354,46,142,13,129
USD,mogo marks native (sharethrough) unique us sx,970x250,770.962765,132209,117692,230,364,54,310
USD,mogo marks perf arts silver sx,160x600,1724.390206,105902,76841,75,538,33,505
USD,mogo marks playbill 5 sx x9z,320x50,1068.072678,71298,67290,142,659,66,593
USD,mogo marks video branding extended reach tail aggregate sx,250x250,47.40468,6208,5167,5,8,0,8
USD,sfoc stratford hqcat sx,970x250,105.319534,10519,9465,7,90,5,85
USD,ttd education sx,300x50,244.812884,65790,61757,28,900,30,870
USD,/All Apps/Apple App Store/Medical,300x50,0.541397,368,347,1,0,0,0
USD,/All Apps/Google Play/Comics,300x250,0.001179,1,1,0,0,0,0
USD,DO NOT USE Tier 2,300x600,5158.838861,576921,515648,471,2455,161,2294
USD,Greg's GG KPI + relevant sites list,320x50,47.745071,2955,2498,2,18,0,18
USD,mogo marks lal branding (All) silver sx,300x250,72766.72009,10120869,7922358,6794,34919,2272,32647
USD,mogo marks ttd obx kitchen premium sink sx,120x600,2.764517,657,338,0,0,0,0
USD,mogo perf arts sx,300x250,8882.381682,1204227,936019,1335,2833,454,2379
USD,/All Apps/Apple App Store/Business,970x250,0.119456,2,1,0,0,0,0
USD,Android Top Selling Free Game,336x280,0.31824,61,45,1,1,0,1
USD,Greg's GG KPI + relevant sites list,728x90,32.256143,1659,1379,7,16,2,14
USD,mogo biz-fi sx,300x100,0.101699,20,17,0,0,0,0
USD,mogo marks shakespeare sx,970x250,1.514128,160,116,0,0,0,0
USD,mogo sports sx,120x600,0.577428,36,29,0,0,0,0
USD,/All Apps/Apple App Store/Games/Educational,300x600,1.921171,93,75,4,0,0,0
USD,/All Apps/Google Play/Photography,160x600,0.0306,5,5,0,0,0,0
USD,Android Top Selling Free Education,300x50,0.179026,26,26,0,0,0,0
USD,mogo marks branding drhbx gold sx,160x600,4140.315642,393818,331795,288,2028,81,1947
USD,mogo marks elite kpi achievers sx,200x200,0.014553,1,0,0,0,0,0
USD,mogo marks t1 brand kpi sx x8t,320x50,4892.967076,943683,869371,694,2676,262,2414
USD,/All Apps/Apple App Store/Games/Adventure,728x90,0.938488,856,839,2,0,0,0
USD,/All Apps/Google Play/Games/Action,300x250,19.359018,1796,1526,24,5,5,0
USD,DO NOT USE Rubicon,970x250,42.130155,6288,2929,3,8,2,6
USD,PAC Singapore sx,300x600,68.761789,2784,2183,3,10,2,8
USD,mogo lydia peacecenter test,250x250,28.492488,4603,3774,0,4,0,4
USD,mogo marks branding comp rate gold video sx,300x250,53744.23909,11513411,9449809,6263,17649,1837,15812
USD,Channel of Top non-US Sites for Nielsen Display Ads - DO NOT EDIT,250x250,73.9214,10539,8709,6,6,0,6
USD,DO NOT USE Tier 2,300x250,12605.04461,2143818,1705080,1422,7572,362,7210
USD,Fan Extender IMG/Sidearm Blacklist,320x50,12.996475,5600,5272,11,3,3,0
USD,mogo canada t1 sx,320x50,15512.62434,2439970,2301766,5040,7391,3482,3909
USD,mogo marks branding tier 3 sx xls37852,300x600,13329.30997,929976,800528,1437,6408,536,5872
USD,mogo marks pav kpi sx,970x250,303.666306,18854,11911,51,189,72,117
USD,mogo marks shakespeare sx,320x100,0.612036,90,80,0,0,0,0
USD,ttd entertainment sx,600x250,0.000272,1,0,0,0,0,0
USD,ttd kids sx,728x90,827.398602,193067,142582,196,427,51,376
USD,ttd male sx,300x100,0.088676,19,17,0,0,0,0
USD,/All Apps/Apple App Store/Games/Puzzle,300x50,12.510105,1716,1685,10,0,0,0
USD,/All Apps/Apple App Store/Games/Word,300x600,549.954988,29604,24969,2409,386,364,22
USD,/All Apps/Google Play/Games/Role Playing,300x50,0.378571,95,94,0,0,0,0
USD,DO NOT USE Invite December Brand Safe List,728x90,28449.25147,6154440,4840530,3375,13736,1011,12725
USD,DO NOT USE Mobile - MoPub - Computers & Electronics/Software/Multimedia Software/Audio & Music Software,728x90,16.245648,27832,27717,4,0,0,0
USD,DO NOT USE Tier 1* (CHANNEL),160x600,9851.07543,2309830,2065763,1040,7846,413,7433
USD,DO NOT USE Tier 3* (CHANNEL) (2),970x90,8.387827,480,426,0,0,0,0
USD,mogo cult soph sx,320x50,16095.94497,2954262,2760039,5820,6687,3635,3052
USD,mogo marks phoenix sx,320x50,235.664169,56892,52451,69,114,26,88
USD,mogo sports sx,300x50,87.490776,20268,19144,19,67,6,61
USD,ttd sports sx,300x100,0.088865,20,18,0,0,0,0
USD,/All Apps/Apple App Store/Entertainment,300x50,29.179102,6658,6252,17,0,0,0
USD,/All Apps/Google Play/Entertainment,300x50,10.352774,4634,4549,2,3,0,3
USD,mogo marks houston sx,468x60,0.002004,1,0,0,0,0,0
USD,mogo marks kpi mdx sx xls9297,336x280,10.98305,857,779,0,3,0,3
USD,mogo marks playbill 5 sx x9z,728x90,192.049338,20133,8714,18,106,13,93
USD,/All Apps/Apple App Store/Games/Casino,300x250,66.51064,6049,4857,179,6,6,0
USD,DO_NOT_USE Bid Manager reportable sites channel (Soon to be deprecated and please exclude channel: Non-reportable sites and apps),250x250,99.574344,12574,10382,4,18,0,18
USD,education master sx,320x100,87.054422,11192,10592,18,19,10,9
USD,kid safe sx,300x50,124.332722,17942,16978,24,244,8,236
USD,pac esports sx,320x50,2285.799897,1277359,1017891,385,904,81,823
USD,/All Apps/Apple App Store/Games/Card,300x50,3.445156,349,345,0,0,0,0
USD,/All Apps/Apple App Store/Games/Dice,970x250,0.107114,1,1,0,0,0,0
USD,Channel of Top US Sites for Nielsen Video Ads - DO NOT EDIT,250x250,93.42799,12248,10259,9,9,0,9
USD,mogo marks native (sharethrough) unique can sx,970x90,76.32208,6187,5174,0,3,0,3
USD,mogo marks natl cat-aff-im sx 2,300x50,100.975631,12426,11951,9,245,7,238
USD,mogo marks video sx xsl44760 class a,120x600,0.006865,4,4,0,0,0,0
USD,mogo marks xsl_ks20780 sx,320x51,0.837271,21,20,0,0,0,0
USD,ttd music sx,120x600,0.12627,15,14,0,0,0,0
USD,BBB black sx,320x50,3.15374,673,643,1,1,1,0
USD,mogo marks video sx xsl44760 class a,300x50,0.836719,192,182,0,0,0,0
USD,sfoc rtx kpi sx,970x250,5.403755,455,403,0,4,0,4
USD,ttd real estate sx,160x600,7.537507,2383,1545,0,6,0,6
USD,ttd weather sx,970x90,10.122206,378,321,3,1,0,1
USD,/All Apps/Google Play/Games/Trivia,970x250,0.011302,10,10,0,0,0,0
USD,Broadway sx,300x250,1.722585,89,84,0,1,0,1
USD,mogo CBS Interactive sx,160x600,62.96424,7551,6662,8,49,0,49
USD,mogo marks branding max reach sx,600x250,0.000272,1,0,0,0,0,0
USD,mogo marks lal (purchase) gold sx,728x90,21064.34386,2364040,1901020,1483,10580,499,10081
USD,mogo marks native sx xsl1045 class a,300x600,3298.453629,394141,334113,311,1289,84,1205
USD,mogo marks perf arts silver sx,336x280,0.891718,38,30,0,2,0,2
USD,mogo marks perf arts sx 5 rx1,970x90,1.608701,167,126,0,2,0,2
USD,mogo marks perf arts sx 7,320x51,0.8361,20,19,0,0,0,0
USD,mogo marks travel sx,250x250,0.091436,6,4,0,0,0,0
USD,/All Apps/Apple App Store/Sports,300x600,8.025561,210,194,3,0,0,0
USD,/All Apps/Google Play/Books & Reference,300x600,19.43133,797,748,14,0,0,0
USD,Channel of Top non-US Sites for Nielsen Video Ads - DO NOT EDIT,336x280,38.134441,8206,7130,9,4,0,4
USD,South Coast Rep Perf Arts 5 black sx,300x600,0.975347,96,86,0,1,0,1
USD,mogo marks agg sx xsl37589,300x50,3053.966613,551407,520503,268,9041,202,8839
USD,mogo marks pav kpi sx 2,970x90,27.994522,1843,1585,1,3,0,3
USD,mogo marks video branding medium reach tail aggregate sx,300x50,2029.637773,364497,346188,205,5300,131,5169
USD,ttd tech sx,320x100,8.646309,1248,1168,0,3,0,3
USD,Walnut Street Theatre - In-Stream Video Blacklist,970x250,0.108732,4,4,0,0,0,0
USD,debartolo local site list,300x250,16.876282,1085,649,0,18,0,18
USD,dso custom hx,300x600,35.96784,1522,1403,0,37,0,37
USD,mogo marks branding tier 3 sx xls37852,160x600,6410.102049,1166509,1070331,617,2839,175,2664
USD,mogo marks video branding max reach tail aggregate sx,728x90,64010.01533,12728636,10178252,6497,34539,2105,32434
USD,pac canada sports sx,970x90,81.418633,6022,5055,1,3,0,3
USD,ttd entertainment sx,300x600,6898.510507,1016714,838965,862,2849,281,2568
USD,/All Apps/Apple App Store/Games/Trivia,300x600,10.147856,367,315,18,0,0,0
USD,/All Apps/Google Play,970x250,5.390885,477,419,5,1,1,0
USD,Android Top Selling Free Sports,300x600,1.141057,388,362,9,0,0,0
USD,DO NOT USE All Google Anonymous (2),300x250,0.00828,2,2,0,0,0,0
USD,DO NOT USE fgu test public channel,728x90,3262.170671,376546,238788,211,772,50,722
USD,Mogo DBM premium video sx,300x100,0.279056,47,45,0,0,0,0
USD,mogo black rt sx,970x250,2.527778,530,398,0,0,0,0
USD,mogo marks native (sharethrough) unique us sx,120x600,0.112777,34,27,0,0,0,0
USD,mogo marks xsl_800p sx,970x250,10357.8175,1342976,1167633,1906,3544,725,2819
USD,sfoc kpi sx (acquisition 2019),970x250,94.694474,9933,8920,14,110,16,94
USD,/All Apps/Apple App Store/Games/Word,160x600,7.220291,380,333,44,0,0,0
USD,/All Apps/Google Play/Photography,300x250,2.418094,541,471,2,0,0,0
USD,DO NOT USE Tier 3* (CHANNEL),300x600,10315.33531,1341645,1079437,1064,5449,325,5124
USD,mogo marks sports sx,300x250,5440.589849,589551,429492,380,1303,108,1195
USD,/All Apps/Apple App Store/Games/Racing,728x90,2.277434,1593,1579,10,1,1,0
USD,/All Apps/Google Play/Games/Casino,300x250,5.98391,270,231,3,0,0,0
USD,DCPA display local sx,728x90,93.1085,7406,5541,4,87,2,85
USD,mogo marks agg sx xsl37589,336x280,188.317111,21687,18624,13,89,0,89
USD,mogo marks cincinnati sx,160x600,0.461603,41,27,0,0,0,0
USD,mogo marks video branding medium reach tail aggregate sx,336x280,68.033524,11295,9850,8,14,0,14
USD,ttd music sx,336x280,0.325503,124,117,0,0,0,0
USD,/All Apps/Apple App Store/Newsstand/News & Politics,300x600,104.244439,22040,16700,68,1,0,1
USD,/All Apps/Apple App Store/Weather,320x100,0.228678,27,27,0,0,0,0
USD,kid safe sx,336x280,2.107807,330,263,0,0,0,0
USD,mogo marks perf arts gold sx,200x200,0.018275,2,1,0,0,0,0
USD,ttd female sx,300x600,2441.652675,196756,176119,186,1279,70,1209
USD,DO_NOT_USE Bid Manager reportable sites channel (Soon to be deprecated and please exclude channel: Non-reportable sites and apps),300x600,55496.61696,6683282,5508291,13050,25960,3204,22756
USD,mogo marks pav kpi hx,120x600,0.056483,18,18,0,0,0,0
USD,mogo marks t1 brand sx trim,320x50,27029.72255,4700020,4390320,8839,10522,4426,6096
USD,mogo marks trip advisor sx,320x50,531.864908,9497,9075,31,163,6,157
USD,mogo marks wsj sx x4v,970x250,77.861596,1590,1353,7,7,1,6
USD,ttd real estate sx,970x250,9.959923,311,264,0,0,0,0
USD,5a local sx seattle,970x90,1.242725,112,74,0,0,0,0
USD,DO NOT USE Invite December Brand Safe List,900x90,0.001275,1,1,0,0,0,0
USD,finn dallas native sx,320x100,0.588915,70,46,0,0,0,0
USD,mogo marks wedding sx,300x50,0.769291,46,44,0,9,0,9
USD,ttd health sx,300x250,3284.303418,323673,255899,219,1899,60,1839
USD,/All Apps/Google Play/Sports,300x50,12.13653,2406,2238,2,2,0,2
USD,Channel of Top US Sites for Nielsen Video Ads - DO NOT EDIT,300x600,42022.22579,5105522,4288363,4717,17625,1718,15907
USD,Performing Arts Fort Worth Top sx,320x50,14.933753,5511,4981,3,17,0,17
USD,mogo CBS Interactive sx,728x90,993.628924,122679,89630,55,343,21,322
USD,mogo marks hq100p sx,300x100,0.636893,117,102,0,0,0,0
USD,mogo marks natl elite cat-aff-im sx,970x250,3847.464609,261542,214022,460,1140,246,894
USD,mogo marks pav kpi hx,300x50,147.327957,35488,32171,14,404,20,384
USD,mogo marks pav kpi sx 3,336x280,0.855777,30,24,0,0,0,0
USD,mogo marks video branding max reach tail aggregate sx,970x66,1.275509,632,175,0,0,0,0
USD,mogo perf arts sx,250x250,0.426678,34,24,0,0,0,0
USD,ttd beauty sx,160x600,84.775673,9694,8605,0,27,0,27
USD,ttd news sx,970x250,6620.652732,679733,586331,1000,1981,424,1557
USD,ttd travel sx,336x280,0.477799,26,23,0,0,0,0
USD,/All Apps/Apple App Store/Entertainment,300x250,552.855566,186614,155656,666,27,25,2
USD,/All Apps/Apple App Store/Games,300x600,1288.155485,54811,46886,4253,623,573,50
USD,/All Apps/Apple App Store/Reference,300x50,5.345701,1784,1687,1,2,0,2
USD,Android Top Selling Free Education,300x250,51.137649,17828,15733,128,76,47,29
USD,Arizona Theatre Company - Site List,300x250,29.36473,4006,3168,7,6,1,5
USD,DO NOT USE Mobile - MoPub - People & Society,300x250,6.525548,1100,982,5,1,0,1
USD,mogo black sx,120x600,0.063257,37,34,0,0,0,0
USD,mogo marks branding tier 2 sx xls37852,300x100,0.541359,108,94,0,0,0,0
USD,mogo marks elite kpi achievers sx,728x90,5997.310825,515426,391514,237,1610,93,1517
USD,mogo marks lal branding (All) silver sx,250x250,33.729281,3364,2759,1,6,0,6
USD,mogo mba tier 2 sx,160x600,1425.893463,203609,175614,69,417,17,400
USD,/All Apps/Apple App Store/Games/Puzzle,300x250,18.044842,1413,1220,15,2,2,0
USD,Arvada local sx,300x250,13.293825,666,565,3,31,2,29
USD,Cal Performances sf local + t1 brand black sx,300x250,97.943901,8045,6927,4,2,0,2
USD,Channel of Top non-US Sites for Nielsen Video Ads - DO NOT EDIT,Unknown,5452.056295,162953,155927,839,110,0,110
USD,Channel of Top non-US Sites for Nielsen Video Ads - DO NOT EDIT,468x60,3.048746,1279,815,0,0,0,0
USD,University of Colorado--Shortlist- HighCTR/ high CPA ,300x250,0,0,0,0,3,0,3
USD,mogo financial services kpi sx,970x90,7.125731,241,203,0,0,0,0
USD,mogo marks coupon sx,250x250,0.803606,25,24,0,0,0,0
USD,Channel of Top US Sites for Nielsen Video Ads - DO NOT EDIT,336x280,130.106675,26491,23008,27,30,0,30
USD,Mogo DBM premium video sx,970x66,0.049613,9,4,0,0,0,0
USD,mogo marks branding elite tier sx xls37852,160x600,1399.942393,108082,80334,80,611,36,575
USD,mogo marks hq100p sx,970x250,6808.997723,895473,787269,1337,2656,548,2108
USD,mogo marks natl canada cat-aff-im sx,970x90,21.615586,1593,1369,2,3,0,3
USD,mogo marks sacramento sx,300x250,226.713391,20392,14820,16,31,8,23
USD,mogo perf arts sx,970x66,0.004991,1,0,0,0,0,0
USD,pac esports sx,300x600,2489.662937,612566,485817,147,1295,58,1237
USD,sfjazz travel sx,160x600,58.927739,5161,4876,5,47,8,39
USD,/All Apps/Apple App Store/Catalogs,300x50,0.025875,6,5,0,0,0,0
USD,/All Apps/Google Play/Productivity,970x250,0.004083,2,1,0,0,0,0
USD,/All Apps/Google Play/Social,728x90,0.087011,176,169,0,0,0,0
USD,DO NOT USE AppNexus - Collective Media,160x600,4530.446251,1690755,1554301,427,1221,122,1099
USD,DO_NOT_USE Bid Manager reportable sites channel (Soon to be deprecated and please exclude channel: Non-reportable sites and apps),336x280,218.174241,25182,21608,14,104,0,104
USD,Stratford KPI sx,160x600,9.415745,890,783,0,38,0,38
USD,mogo marks perf arts gold sx,468x60,0.004844,2,0,0,0,0,0
USD,mogo marks t1 brand sx trim,250x250,18.453144,2173,1727,1,4,0,4
USD,/All Apps/Apple App Store/Games,336x280,0.042493,9,4,0,0,0,0
USD,/All Apps/Google Play/Games/Word,336x280,0.021841,9,5,0,0,0,0
USD,Performing Arts Fort Worth Perf Arts 5 black sx,970x250,0.735224,63,56,0,1,0,1
USD,mogo financial services kpi sx,468x60,0.006168,3,3,0,0,0,0
USD,mogo marks video sx xsl44760 class c,160x600,11775.9393,3509669,3141568,1341,3953,381,3572
USD,ttd music sx,300x100,0.030841,6,6,0,0,0,0
USD,/All Apps/Google Play/Business,300x50,0.005799,3,3,0,0,0,0
USD,DO NOT USE Tier 2,970x66,0.070801,68,15,0,0,0,0
USD,at atlanta sx,320x50,22.748317,5256,4663,5,17,1,16
USD,mogo marks bay area sx,970x250,39.312759,6141,2788,5,10,2,8
USD,mogo marks branding tier 1 sx xls37852,970x90,230.375965,18754,16045,16,21,1,20
USD,mogo marks branding tier 2 sx xls37852,970x250,8752.146806,762576,643833,1386,3234,647,2587
USD,mogo marks disney sx,300x100,0.047234,4,3,0,0,0,0
USD,mogo marks lal (purchase) platinum sx,320x100,11.703228,753,568,0,7,0,7
USD,mogo marks perf arts platinum sx,160x600,1701.079585,102194,74696,72,524,30,494
USD,mogo marks san francisco sx,160x600,16.221208,2280,1233,2,5,0,5
USD,mogo marks xsl66781 sx,970x250,5448.462184,507159,431137,826,2032,426,1606
USD,dbm native sx (adx),970x90,25.340768,1680,1377,3,4,0,4
USD,mogo marks lal (purchase) gold sx,300x250,37828.02659,4509942,3468035,3460,16981,1285,15696
USD,mogo marks native sx xsl1045 class a,468x60,0.228814,46,41,0,0,0,0
USD,/All Apps/Apple App Store/Games/Music,320x50,2.593871,741,707,11,0,0,0
USD,/All Apps/Google Play/Games/Sports,728x90,0.062715,56,54,0,0,0,0
USD,/All Apps/Google Play/Games/Word,300x250,42.072743,3119,2854,20,2,2,0
USD,/All Apps/Google Play/Health & Fitness,300x250,4.155413,229,198,6,1,0,1
USD,DO NOT USE Rubicon,160x600,527.418901,263709,235403,235,180,49,131
USD,mogo marks native medium reach tail aggregate sx,320x50,73007.71215,17785985,16567054,21709,28699,8374,20325
USD,mogo marks perf arts branding high reach sx,970x250,375.045436,25153,17506,73,221,77,144
USD,mogo marks sacramento sx,970x250,2.612876,162,110,2,0,0,0
USD,mogo marks toronto sx,970x250,39.591504,4081,2967,4,31,0,31
USD,Channel of Top US Sites for Nielsen Video Ads - DO NOT EDIT,300x250,150959.4551,32060247,25912737,17166,53069,4535,48534
USD,mogo marks kpi mdx sx xls9297,970x66,0.025054,4,3,0,0,0,0
USD,mogo marks playbill 5 sx x9z,160x600,66.514515,3547,3120,8,24,1,23
USD,mogo marks san francisco sx,970x90,1.95632,181,131,0,0,0,0
USD,ttd auto sx,728x90,680.433172,54534,46892,28,205,5,200
USD,ttd entertainment sx,Unknown,5452.056295,162953,155927,839,110,0,110
USD,ttd kids sx,160x600,912.904249,489905,427151,332,291,93,198
USD,/All Apps/Apple App Store/Games/Racing,300x600,0.189287,9,8,0,0,0,0
USD,/All Apps/Apple App Store/Games/Strategy,728x90,7.468375,7441,7343,20,3,3,0
USD,/All Apps/Apple App Store/Social Networking,320x50,435.13361,161168,153677,425,3,1,2
USD,DCPA display local sx,300x600,8.871684,279,227,0,2,0,2
USD,DO NOT USE Invite US Expandable Enabled Sites,300x50,59.035683,15534,14706,5,97,5,92
USD,DO NOT USE Tier 2* (CHANNEL),320x100,31.417254,3036,2804,9,11,5,6
USD,mogo marks branding elite tier sx xls37852,970x90,15.396509,726,637,1,2,0,2
USD,mogo marks branding tier 3 sx xls37852,250x250,11.132257,1006,808,0,4,0,4
USD,mogo marks native sx xsl1045 class c,300x250,30580.48041,6511846,5271558,3663,11052,1013,10039
USD,mogo marks video sx xsl44760 class c,970x90,111.802952,8721,7414,9,9,0,9
USD,Channel of Top Global Sites for Nielsen Video Ads - DO NOT EDIT,728x90,58731.95115,12500177,10204577,5949,30451,1919,28532
USD,DO NOT USE Mobile - MoPub - Arts & Entertainment,300x600,0.53753,13,12,0,0,0,0
USD,DO NOT USE Mobile - MoPub - Arts & Entertainment/Music & Audio,320x50,20.312376,42534,42388,59,0,0,0
USD,DO NOT USE Tier 3,900x90,0.001275,1,1,0,0,0,0
USD,DO NOT USE fgu test public channel,300x600,51.412634,6352,4968,9,13,3,10
USD,Mogo DBM basic video sx,728x90,1277.133299,288024,240411,143,629,45,584
USD,dbm video sx,300x250,59407.54349,11348935,9255318,6735,22917,1958,20959
USD,mogo marks lal (purchase) gold sx,200x200,0.447882,33,27,0,0,0,0
USD,ttd finance sx,300x250,13204.7572,1813919,1467583,1859,4198,569,3629
USD,/All Apps/Apple App Store/Games/Strategy,320x50,7.156289,5485,5305,11,0,0,0
USD,DO NOT USE Tier 3* (CHANNEL) (2),300x250,2628.628524,492209,372292,296,1990,94,1896
USD,Lynn General,336x280,1.207442,40,38,0,0,0,0
USD,mogo cult soph sx,160x600,2560.098059,451941,390750,204,897,51,846
USD,mogo marks branding comp rate silver video sx,320x50,32581.87381,7857239,7344261,11278,13307,5354,7953
USD,mogo marks branding drhbx silver sx,320x50,60354.72246,13497783,12473437,17190,26411,6974,19437
USD,mogo marks perf arts sx 2,320x51,0.8361,20,19,0,0,0,0
USD,/All Apps/Apple App Store/Games/Action,300x250,0.818551,111,64,1,0,0,0
USD,/All Apps/Google Play/Lifestyle,728x90,5.415849,3000,2886,4,0,0,0
USD,Android Top Selling Free News and Magazines,300x250,2475.012413,409793,372851,727,165,88,77
USD,Channel of Top Global Sites for Nielsen Video Ads - DO NOT EDIT,970x66,0.901289,295,151,0,0,0,0
USD,mogo centro sx US (2014),300x100,0.537469,88,81,0,0,0,0
USD,mogo marks branding tier 1 sx xls37852,468x60,2.428967,754,568,0,0,0,0
USD,ttd music sx,970x250,75.707393,23561,17160,26,59,28,31
USD,/All Apps/Apple App Store/Games/Card,728x90,676.601863,401971,396236,1133,103,87,16
USD,Duxiana - Underperformance Blacklist,970x250,74.772146,51193,46513,108,2,2,0
USD,mogo black sx,160x600,947.720768,365719,325469,309,371,68,303
USD,mogo marks natl cat-aff-im sx 2,970x250,5508.206365,503949,428916,848,2062,445,1617
USD,mogo marks t1 brand sx trim,970x66,0.217453,37,17,0,0,0,0
USD,/All Apps/Apple App Store/Games/Racing,300x50,0.048674,18,18,0,0,0,0
USD,/All Apps/Apple App Store/Music,300x600,2.211794,164,130,3,0,0,0
USD,kid safe sx,970x250,1664.27607,503771,466075,536,554,157,397
USD,mogo marks agg sx xsl37589,970x250,11842.08199,1448329,1263219,2119,4142,767,3375
USD,mogo marks lal branding (All) gold sx,250x250,21.619145,1881,1571,0,4,0,4
USD,mogo marks perf arts branding high reach sx,970x66,0.004991,1,0,0,0,0,0
USD,mogo marks perf arts gold sx,320x50,1577.599971,132961,108521,199,943,95,848
USD,mogo marks xsl_ks0001 sx,Unknown,5452.056295,162953,155927,839,110,0,110
USD,mogo sports sx,468x60,0.139416,26,20,0,0,0,0
USD,pac esports sx,336x280,0.005576,5,5,0,0,0,0
USD,sfoc marks kpi sx (062018),300x250,197.885619,21387,19742,19,376,15,361
USD,/All Apps/Apple App Store/Productivity,320x50,73.271385,37367,36289,81,1,1,0
USD,Performing Arts Fort Worth sx,970x250,2.490449,113,90,0,0,0,0
USD,mogo financial services kpi sx,320x50,7582.575744,2232728,1904794,2838,2164,739,1425
USD,mogo marks branding tier 2 sx xls37852,240x400,0.054511,6,5,0,0,0,0
USD,mogo marks branding tier 3 sx xls37852,320x51,0.8361,20,19,0,0,0,0
USD,mogo marks shakespeare sx,300x600,9.743643,799,630,2,0,0,0
USD,mogo marks video branding extended reach tail aggregate sx,200x200,2.990179,245,176,0,1,0,1
USD,/All Apps/Apple App Store/Lifestyle,728x90,196.641831,38277,35451,84,7,5,2
USD,DO NOT USE Tier 3* (CHANNEL),300x100,0.727688,134,122,0,0,0,0
USD,Duxiana- Bad Site List(Allan) ,300x600,66.589057,15498,14164,16,1,0,1
USD,Provident High CTR List ,160x600,44.609702,3968,3732,0,0,0,0
USD,Stratford Black RT SX,300x250,1.471367,330,296,0,3,0,3
USD,mogo marks branding drhbx platinum sx,970x250,3758.292523,258573,212589,456,1114,202,912
USD,mogo marks high intenders sx,300x250,3581.028182,489133,369105,347,1678,116,1562
USD,mogo marks jazz & blues sx,320x50,472.364504,88291,80977,35,318,34,284
USD,mogo marks video branding medium reach tail aggregate sx,970x250,10257.71603,1328331,1161376,1845,3548,640,2908
USD,mogo marks video sx xsl44760 class b,300x600,5474.915393,816452,636514,754,1766,278,1488
USD,mogo marks xsl_ks0001 sx,468x60,3.006496,1255,905,0,0,0,0
USD,sfoc cix sx,970x250,8.70447,401,316,0,19,0,19
USD,zt local austin sx,300x250,74.55567,14477,11874,18,102,8,94
USD,/All Apps/Apple App Store/Navigation,320x50,112.372498,11081,10338,73,1,0,1
USD,RCU Blacklist Sites (CPA),160x600,32.235156,3430,3308,3,2,0,2
USD,mogo marks perf arts gold sx,970x250,285.944351,18182,11426,48,182,69,113
USD,mogo marks perf arts silver sx,250x250,0.159429,28,16,0,0,0,0
USD,mogo marks sports sx,250x250,0.573128,73,60,0,0,0,0
USD,sfoc stratford hqcat sx,300x250,447.558549,55244,50175,51,647,42,605
USD,stratford black OB sx,160x600,0.014055,11,10,0,0,0,0
USD,ttd auto sx,970x66,0.041119,6,4,0,0,0,0
USD,ttd health wellness sx,970x90,3.63959,979,895,2,2,0,2
USD,ttd shopping sx,970x66,0.041119,6,4,0,0,0,0
USD,DO NOT USE Invite December Brand Safe List,300x600,23305.7965,2481561,2016213,2699,9547,907,8640
USD,DO_NOT_USE Bid Manager reportable sites channel (Soon to be deprecated and please exclude channel: Non-reportable sites and apps),160x600,43304.42947,10922491,9625127,5834,22422,1672,20750
USD,mogo marks native sx xsl1045 class c,160x600,2446.663363,426540,359724,145,933,33,900
USD,mogo marks pav kpi sx,300x600,521.528768,47841,34569,64,205,26,179
USD,ttd kids sx,300x600,145.323564,42527,39774,28,78,11,67
USD,/All Apps/Apple App Store/Sports,728x90,62.582436,30792,29695,37,1,0,1
USD,/All Apps/Google Play/Books & Reference,728x90,2.725251,1608,1536,2,0,0,0
USD,/All Apps/Google Play/Music & Audio,728x90,1.966601,3590,3542,3,0,0,0
USD,5a kpi sx,970x250,42.525496,1148,841,0,11,0,11
USD,Brandcast Blacklist ,320x50,2601.562587,1702285,1422045,432,983,93,890
USD,DO NOT USE Rubicon,300x600,1087.531393,239105,129216,86,395,30,365
USD,mogo financial services kpi sx,970x250,1065.259862,327936,305626,314,515,69,446
USD,mogo marks branding max reach sx,970x90,430.600726,32531,28221,36,39,1,38
USD,mogo marks disney sx,970x250,0.227957,14,5,0,0,0,0
USD,mogo marks lal branding (All) gold sx,240x400,0.042086,3,2,0,0,0,0
USD,mogo marks wine sx,300x50,0.311622,159,152,0,0,0,0
USD,mogo marks xsl_ks0001 sx,300x100,1.312069,226,195,0,0,0,0
USD,/All Apps/Apple App Store/Lifestyle,320x100,0.240551,32,31,0,0,0,0
USD,Channel of Top US Sites for Nielsen Video Ads - DO NOT EDIT,160x600,27503.26516,7648646,6785855,2958,11596,842,10754
USD,DSM African American sx,300x250,3.575893,524,446,0,3,0,3
USD,Mogo DBM premium video sx,468x60,0.03977,9,5,0,0,0,0
USD,mogo marks classical music sx,468x60,0.001798,2,2,0,0,0,0
USD,mogo marks denver sx,320x50,632.45568,134567,122080,154,421,37,384
USD,mogo marks video sx xsl44760 class b,120x600,0.06125,48,30,0,0,0,0
USD,/All Apps/Google Play/Music & Audio,320x50,491.04049,359249,348164,390,49,17,32
USD,Android Top Selling Free Music and Audio,336x280,0.082587,35,23,2,3,3,0
USD,South Coast Rep Perf Arts 5 black sx,728x90,1.261492,123,112,0,0,0,0
USD,mogo marks jazz & blues sx,970x250,4.733101,243,216,0,2,0,2
USD,mogo marks native sx xsl1045 class a,728x90,4910.555125,1197706,976418,1002,2647,104,2543
USD,ttd food sx,300x100,0.187876,31,23,0,0,0,0
USD,/All Apps/Apple App Store/Games/Music,728x90,1.404663,446,432,6,0,0,0
USD,DCPA display local sx,300x250,35.166614,4213,2875,5,10,1,9
USD,DO NOT USE Invite December Brand Safe List,300x100,1.127285,188,165,0,0,0,0
USD,DO NOT USE Mobile - MoPub - Arts & Entertainment/Music & Audio,728x90,16.245648,27832,27717,4,0,0,0
USD,DO NOT USE Tier 1,728x90,37060.82296,6658059,5147098,4977,15804,1189,14615
USD,mogo marks native (sharethrough) unique us sx,300x100,0.50961,100,86,0,0,0,0
USD,mogo marks rt+ob lt_lq black sx  ,320x50,1.412613,5540,5482,2,0,0,0
USD,/All Apps/Apple App Store/Travel,320x50,236.920033,64023,56705,174,2,2,0
USD,/All Apps/Google Play/Books & Reference,300x50,3.137818,598,571,0,12,4,8
USD,Android Top Selling Free Entertainment,320x50,197.824509,246655,243869,647,47,38,9
USD,DO NOT USE Mobile - MoPub - Arts & Entertainment,300x250,182.675362,105809,104279,88,4,3,1
USD,DO NOT USE fgu test public channel,300x250,14450.4714,3311095,2809002,1000,3504,263,3241
USD,mogo canada t1 sx,160x600,1947.762262,252927,221671,109,702,35,667
USD,mogo marks native sx xsl1045 class a,300x50,90.011118,12467,11959,12,349,7,342
USD,mogo marks perf arts sx 7,160x600,1541.160499,87233,62968,61,493,24,469
USD,ttd entertainment sx,468x60,0.406817,134,112,0,0,0,0
USD,/All Apps/Apple App Store/Social Networking,728x90,5.964549,7162,7099,11,0,0,0
USD,DO_NOT_USE Bid Manager reportable sites channel (Soon to be deprecated and please exclude channel: Non-reportable sites and apps),240x400,0.274451,25,16,0,0,0,0
USD,mogo marks xsl_800p sx,120x600,5.660989,959,747,0,0,0,0
USD,/All Apps/Google Play/Games/Puzzle,320x50,357.729253,171989,168872,939,145,131,14
USD,mogo marks branding comp rate silver video sx,728x90,23444.14997,5050740,3884980,2604,9124,747,8377
USD,mogo marks branding drhbx platinum sx,320x50,2842.873304,368227,334437,414,1338,125,1213
USD,mogo marks native medium reach tail aggregate sx,728x90,43717.38262,8355612,6634527,4260,25743,1428,24315
USD,mogo marks native sx xsl1045 class a,120x600,0.039375,9,4,0,0,0,0
USD,mogo marks native sx xsl1045 class b,970x90,22.341206,2887,2287,0,3,0,3
USD,mogo marks phoenix sx,160x600,0.164264,32,26,0,0,0,0
USD,mogo marks video branding extended reach tail aggregate sx,320x50,60532.50558,15714143,14611930,18836,23700,7515,16185
USD,pac esports sx,970x250,16.37226,971,760,1,1,0,1
USD,/All Apps,300x250,7788.087445,1868674,1647361,4587,906,718,188
USD,/All Apps/Apple App Store/Games/Casino,300x50,2.743561,213,211,0,0,0,0
USD,DO NOT USE Tier 3* (CHANNEL),468x60,7.036448,2567,1876,0,1,0,1
USD,mogo marks branding drhbx silver sx,728x90,42873.73014,6917030,5290394,3272,23757,1212,22545
USD,ttd spanish sx,250x250,0.31314,45,32,0,0,0,0
USD,/All Apps/Google Play/Games/Arcade,970x250,0.182714,5,4,0,0,0,0
USD,DO NOT USE Tier 1,120x600,2.887532,540,446,0,0,0,0
USD,DO NOT USE Tier 2,970x90,34.434362,3188,2791,4,9,0,9
USD,Lynn General,728x90,355.602237,93654,87789,35,206,19,187
USD,Performing Arts Fort Worth sx,300x600,6.411816,360,298,1,2,1,1
USD,at iab aff-im black sx,300x600,16.90705,1100,932,1,2,0,2
USD,mogo marks kpi mdx sx xls9297,160x600,4051.733182,474244,400159,263,1726,78,1648
USD,mogo marks natl cat-aff-im sx 2,300x600,8878.973716,1017998,895074,964,3418,408,3010
USD,mogo marks xsl_800p sx,300x100,2.048486,445,391,1,0,0,0
USD,zt perf arts black sx 5,728x90,0.203533,85,71,0,0,0,0
USD,/All Apps/Apple App Store/Newsstand/Regional News,320x50,0.00759,2,2,0,0,0,0
USD,Duxiana - Longtail Blacklist,300x250,147.880268,77927,65162,51,0,0,0
USD,Duxiana - Underperformance Blacklist,300x600,140.331705,44371,36791,48,3,0,3
USD,mogo marks xsl66781 sx,336x280,13.490726,987,905,0,2,0,2
USD,/All Apps/Apple App Store/Lifestyle,300x600,3.202603,135,110,9,0,0,0
USD,Channel of Top non-US Sites for Nielsen Video Ads - DO NOT EDIT,200x200,3.746715,160,95,0,1,0,1
USD,DO NOT USE Microsoft Bin (001),160x600,0.197377,112,87,0,0,0,0
USD,arizona opera top converters sx,728x90,25.138741,3679,3429,4,16,3,13
USD,co top 41 converting,160x600,9.346165,692,560,1,0,0,0
USD,mogo marks branding tier 2 sx xls37852,336x280,22.494994,1865,1630,0,9,0,9
USD,mogo perf arts sx,970x90,15.530524,754,666,1,2,0,2
USD,Channel of Top Global Sites for Nielsen Display Ads - DO NOT EDIT,970x250,11322.62121,1423079,1243184,2007,3928,722,3206
USD,Performing Arts Fort Worth Test List,160x600,34.623545,3750,2295,2,19,1,18
USD,kid safe sx,300x600,7544.564559,725778,624582,856,2458,291,2167
USD,maryland-dc sx,320x50,7.421068,5007,4344,2,2,1,1
USD,mogo black sx,250x250,1.343569,140,116,0,1,0,1
USD,mogo marks dallas sx,250x250,0.062142,6,3,0,0,0,0
USD,mogo marks hq100p sx,336x280,15.02692,1158,1043,0,3,0,3
USD,mogo marks native (sharethrough) unique can sx,970x66,0.022464,12,2,0,0,0,0
USD,mogo marks video branding max reach tail aggregate sx,300x100,2.727311,586,525,1,0,0,0
USD,nancy sitelist (Advertiser Level),320x50,0.699101,23,22,0,0,0,0
USD,/All Apps/Apple App Store/Catalogs,728x90,0.448998,198,194,0,0,0,0
USD,/All Apps/Apple App Store/Games/Family,728x90,29.204882,16439,16211,50,1,0,1
USD,/All Apps/Google Play/Business,320x50,4.525989,5500,4929,4,4,4,0
USD,/All Apps/Google Play/Games/Board,160x600,0.432556,44,43,5,1,1,0
USD,/All Apps/Google Play/Productivity,336x280,0.006066,2,2,0,0,0,0
USD,LSSU url v1,300x250,114.603325,15164,14009,11,348,5,343
USD,Triad Stage Local sx,300x600,3.896706,176,139,0,1,0,1
USD,mogo marks agg sx xsl37589,300x600,52719.80994,6411737,5311779,5763,24966,2121,22845
USD,mogo marks houston sx,728x90,178.886985,30237,24301,52,29,4,25
USD,mogo marks perf arts sx 5 epx1,300x250,4478.048764,306803,218798,408,1804,189,1615
USD,mogo marks philadelphia sx,728x90,94.999393,20106,18657,32,16,7,9
USD,mogo marks video branding medium reach tail aggregate sx,300x600,36850.97237,4334003,3603920,4099,15884,1515,14369
USD,mogo marks video sx xsl44760 class a,300x600,1998.083162,224673,191287,296,624,115,509
USD,sfoc cix sx,300x600,42.348358,2111,1971,4,105,10,95
USD,ttd music sx,300x600,291.546414,37456,24171,31,127,13,114
USD,DO NOT USE Tier 1* (CHANNEL),300x600,28535.05479,3046280,2549414,3534,12881,1316,11565
USD,/All Apps/Google Play/Games/Arcade,300x250,14.277141,1085,994,13,3,3,0
USD,African American Interests sx,160x600,0.023141,3,2,0,0,0,0
USD,DO NOT USE AppNexus - Collective Media,320x51,0.8361,20,19,0,0,0,0
USD,DO NOT USE Invite December Brand Safe List,970x90,122.66705,10934,9355,10,14,1,13
USD,DO NOT USE Spanish Language Sites,320x50,249.115618,167072,158495,125,143,16,127
USD,RCU Blacklist Sites (CPA),970x250,2.359019,168,150,0,0,0,0
USD,mogo marks branding comp rate platinum video sx,320x100,7.549978,2069,1859,6,4,3,1
USD,mogo marks kpi achievers sx,320x50,8442.046376,423671,385618,3324,4240,2956,1284
USD,mogo marks native (sharethrough) unique us sx,970x90,76.163331,6178,5170,0,3,0,3
USD,mogo marks travel sx,970x250,5.602747,221,158,0,0,0,0
USD,mogo marks xsl_ks20780 sx,336x280,123.836781,12651,10919,5,49,0,49
USD,/All Apps/Apple App Store/Entertainment,320x100,0.093276,184,143,0,0,0,0
USD,/All Apps/Apple App Store/Games,970x250,28.440827,1314,1187,29,3,3,0
USD,Channel of Top US Sites for Nielsen Video Ads - DO NOT EDIT,970x250,10287.22111,1261160,1091287,1863,3558,689,2869
USD,mogo marks branding drhbx gold sx,300x600,10615.34075,789484,680311,1081,6369,433,5936
USD,mogo marks chicago sx,728x90,496.421916,173124,138744,135,186,89,97
USD,ttd health sx,320x100,12.307518,1551,1439,3,4,1,3
USD,/All Apps/Apple App Store/Games/Puzzle,320x100,0.007964,5,5,0,0,0,0
USD,/All Apps/Google Play/Social,300x50,103.783065,18742,17517,53,1,1,0
USD,Blacklist - Verification,300x250,0.949088,261,176,0,1,0,1
USD,Channel of Top non-US Sites for Nielsen Video Ads - DO NOT EDIT,120x600,2.348401,688,562,0,0,0,0
USD,DO_NOT_USE Bid Manager reportable sites channel (Soon to be deprecated and please exclude channel: Non-reportable sites and apps),970x250,11266.80976,1452600,1261736,2103,3815,768,3047
USD,DO_NOT_USE BlackList,300x250,0.017911,1,1,0,0,0,0
USD,dbm native sx (adx),970x66,0.046849,12,5,0,0,0,0
USD,mogo marks cincinnati sx,728x90,80.528441,11880,9814,2,22,1,21
USD,mogo marks perf arts sx 7,336x280,0.851669,34,26,0,1,0,1
USD,mogo marks video branding extended reach tail aggregate sx,468x60,3.022819,943,597,0,0,0,0
USD,central city  opera black sx,300x600,0.249579,7,7,0,0,0,0
USD,mogo marks native sx xsl1045 class b,320x50,8734.520035,2714310,2530633,2034,3312,629,2683
USD,mogo marks playbill sx x3e,320x50,1068.068768,71296,67290,142,659,66,593
USD,mogo marks t1 brand sx trim,300x600,17356.36675,1708915,1398631,1789,5938,651,5287
USD,mogo marks trip advisor sx,300x600,200.525531,3070,2498,8,44,0,44
USD,mogo marks video sx xsl44760 class b,300x250,41809.34676,10591782,8887977,4386,12450,1237,11213
USD,ocfta perf arts black sx 5,320x50,0.007935,1,1,0,0,0,0
USD,ttd news sx,300x50,334.973576,52727,50017,40,535,19,516
USD,ttd weather sx,200x200,0.03887,3,3,0,0,0,0
USD,Channel of Top US Sites for Nielsen Video Ads - DO NOT EDIT,Unknown,5452.056295,162953,155927,839,110,0,110
USD,Channel of Top US Sites for Nielsen Video Ads - DO NOT EDIT,468x60,10.554836,4356,2867,0,1,0,1
USD,Diablo DVC Shortlist (Advertiser Level),160x600,431.966068,44949,40078,22,4445,43,4402
USD,mogo marks expedia sx,728x90,19.833401,834,534,2,59,1,58
USD,mogo marks lal (purchase) gold sx,970x90,109.852321,6491,5565,10,11,0,11
USD,mogo marks lal branding (All) silver sx,336x280,65.576936,3939,3505,2,24,0,24
USD,mogo perf arts sx,336x280,0.923606,50,37,0,1,0,1
USD,DO_NOT_USE Bid Manager reportable sites channel (Soon to be deprecated and please exclude channel: Non-reportable sites and apps),Unknown,5452.056295,162953,155927,839,110,0,110
USD,Stratford KPI sx,728x90,14.653863,1959,1747,1,23,1,22
USD,ttd news sx,120x600,0.387804,23,17,0,0,0,0
USD,DO NOT USE Tier 1,970x66,0.409152,94,25,0,0,0,0
USD,DO_NOT_USE Bid Manager reportable sites channel (Soon to be deprecated and please exclude channel: Non-reportable sites and apps),468x60,13.89959,4723,3311,0,2,0,2
USD,mogo marks branding elite tier sx xls37852,728x90,5725.801485,434982,337484,246,1453,90,1363
USD,mogo marks kpi mdx sx xls9297,300x50,61.193559,9466,9103,4,144,5,139
USD,mogo marks native high reach tail aggregate sx,728x90,51776.55457,9875030,7886188,5079,29311,1750,27561
USD,mogo marks video sx xsl44760 class c,728x90,33100.33968,6586324,5079446,3119,18704,1026,17678
USD,Performing Arts Fort Worth Top sx,300x600,56.885351,6782,6221,7,8,1,7
USD,cmt perf arts black sx 7,728x90,0.026163,4,4,0,0,0,0
USD,mogo black sx,300x100,0.062916,7,5,0,0,0,0
USD,mogo marks native (sharethrough) unique can sx,970x250,760.337532,130320,116399,229,364,54,310
USD,mogo marks pav kpi sx 2,200x200,0.014553,1,0,0,0,0,0
USD,mogo marks perf arts sx 5 rx1,200x200,0.051604,6,5,0,0,0,0
USD,mogo marks san francisco sx,728x90,1778.145354,315030,166438,71,628,25,603
USD,mogo marks travel sx,468x60,0.055157,12,2,0,0,0,0
USD,sfjazz travel sx,728x90,75.750891,4605,4268,4,28,2,26
USD,/All Apps/Apple App Store/Games,320x50,608.198059,424043,408813,939,36,19,17
USD,/All Apps/Apple App Store/Newsstand,970x250,0.064745,4,2,0,0,0,0
USD,mogo marks broadwayworld sx,336x280,0.743167,30,22,0,1,0,1
USD,sfoc pslx 2018 sx (Jun_2018_Archived),300x250,2286.596025,491837,455173,268,3697,238,3459
USD,ttd sports sx,300x250,6861.494903,818892,600530,504,1674,132,1542
USD,/All Apps/Apple App Store/Health & Fitness,300x250,2.840938,229,190,7,0,0,0
USD,Channel of Top US Sites for Nielsen Video Ads - DO NOT EDIT,320x50,104387.1776,30663029,28649549,31023,38196,10695,27501
USD,mogo marks bw-theatre sx,300x600,5.909289,618,360,2,5,1,4
USD,mogo marks native high reach tail aggregate sx,240x400,0.204033,17,14,0,0,0,0
USD,mogo marks wedding sx,970x250,1.307295,86,64,1,0,0,0
USD,mogo marks xsl66781 sx,300x50,174.154987,34534,31392,17,512,19,493
USD,mogo marks xsl_74205 (2p dims) sx ,160x600,5061.720096,1090906,967294,451,2053,131,1922
USD,pac motorsports sx,970x250,721.69679,48442,42128,107,148,18,130
USD,ttd food sx,320x100,35.359502,13777,13277,15,38,4,34
USD,ttd health sx,728x90,2124.503496,199813,158056,90,1457,35,1422
USD,/All Apps/Apple App Store/Games/Simulation,728x90,11.440092,4019,3876,37,0,0,0
USD,Cal Performances sf local + t1 brand black sx,728x90,9.554002,922,807,0,0,0,0
USD,DO NOT USE Tier 3,336x280,110.750351,10775,9096,6,54,0,54
USD,Lynn DMAC,300x250,506.184855,153409,144313,32,157,17,140
USD,Triad Stage Perf Arts black sx,160x600,0.005175,2,2,0,0,0,0
USD,mogo marks native standard reach (no) tail aggregate sx,300x50,1160.151611,180131,171377,97,3259,87,3172
USD,mogo marks outbound kpi sx x1a,160x600,1908.142359,138159,110833,84,739,29,710
USD,pac esports sx,Unknown,5452.056295,162953,155927,839,110,0,110
USD,ttd male sx,300x250,4835.468718,1706559,1216624,456,1801,188,1613
USD,/All Apps/Apple App Store/Entertainment,728x90,1981.95383,948987,922308,3156,289,263,26
USD,Android Top Selling Free Education,728x90,0.002271,9,9,0,0,0,0
USD,Arizona Theatre Company - Site List,728x90,1.176513,371,258,0,0,0,0
USD,mogo marks branding comp rate platinum video sx,728x90,12591.05828,1921546,1282207,1393,3424,296,3128
USD,mogo marks high intenders sx,970x90,5.11802,681,646,1,0,0,0
USD,mogo marks pav kpi sx 3,250x250,0.625209,80,67,0,0,0,0
USD,mogo marks travel sx,728x90,1246.062642,91536,81060,242,502,13,489
USD,pac canada sports sx,336x280,1.979638,182,141,0,0,0,0
USD,ttd entertainment sx,970x66,0.108381,29,12,0,0,0,0
USD,/All Apps/Apple App Store/Games/Puzzle,728x90,1100.536379,414013,399728,1891,180,169,11
USD,Arvada local sx,728x90,7.120133,361,311,0,16,0,16
USD,Channel of Top non-US Sites for Nielsen Video Ads - DO NOT EDIT,300x600,21521.22636,2658818,2316907,2128,9879,778,9101
USD,DO_NOT_USE Bid Manager reportable sites channel (Soon to be deprecated and please exclude channel: Non-reportable sites and apps),320x50,127186.8313,38272087,35282827,41738,47452,12305,35147
USD,mogo marks bay area sx,300x50,46.300702,5044,4615,3,47,0,47
USD,mogo marks lal branding (All) silver sx,160x600,16387.0295,2503174,2114683,1533,13076,530,12546
USD,mogo marks pav kpi hx,970x250,4710.728659,410908,342147,647,1672,297,1375
USD,Channel of Top non-US Sites for Nielsen Video Ads - DO NOT EDIT,300x250,90931.78786,19470205,16188958,10360,30479,2750,27729
USD,DCPA display local sx,320x50,96.681311,18814,15715,10,46,0,46
USD,Duxiana Broadcast blacklist,300x250,0.573269,333,254,0,0,0,0
USD,mogo marks branding comp rate gold video sx,160x600,7939.855583,2524489,2323095,1157,3980,271,3709
USD,mogo marks houston sx,250x250,0.01173,2,2,0,0,0,0
USD,mogo marks pav kpi sx,970x90,9.32949,1071,916,0,1,0,1
USD,mogo marks perf arts sx 5 epx1,336x280,0.997377,39,31,0,2,0,2
USD,mogo marks ttd obx kitchen premium sink sx,300x100,1.229352,214,184,0,0,0,0
USD,mogo marks xsl_74205 (2p dims) sx ,300x100,0.036278,9,9,0,0,0,0
USD,stratford black OB sx,728x90,0.038819,14,12,0,0,0,0
USD,ttd finance sx,728x90,7552.215144,696172,567001,334,2065,149,1916
USD,/All Apps/Google Play/Photography,300x600,7.446076,1149,1018,12,1,1,0
USD,DO NOT USE Mobile - MoPub - Arts & Entertainment,728x90,38.431177,41657,40897,32,1,1,0
USD,/All Apps/Apple App Store/Games/Racing,320x50,1.697276,1923,1869,1,0,0,0
USD,/All Apps/Google Play/Games/Casino,300x600,3.89622,128,113,0,0,0,0
USD,dbm video sx,728x90,21852.13102,3676547,2747876,2042,12526,637,11889
USD,mogo marks lal branding (All) gold sx,300x50,1179.324036,120396,114110,84,3556,57,3499
USD,mogo marks native sx xsl1045 class c,728x90,14705.23665,3179310,2596601,1847,8010,399,7611
USD,mogo marks natl cat-aff-im sx 2,336x280,11.769526,877,798,0,2,0,2
USD,Chicago T1 sites,160x600,27.759752,4660,3845,5,9,2,7
USD,DO NOT USE Tier 3* (CHANNEL) (2),728x90,2359.288383,457317,381954,246,2153,102,2051
USD,DO_NOT_USE Bid Manager reportable sites channel (Soon to be deprecated and please exclude channel: Non-reportable sites and apps),600x250,0.000272,1,0,0,0,0,0
USD,DO_NOT_USE Mobile - MoPub - Games,300x50,0.839822,353,349,0,0,0,0
USD,mogo marks lal branding (All) silver sx,300x100,0.635093,113,103,0,0,0,0
USD,mogo marks t1 brand kpi sx x8t,970x66,0.024281,5,1,0,0,0,0
USD,mogo marks xsl_74205 (4p dims) sx ,468x60,0.004844,2,0,0,0,0,0
USD,ttd family parent sx,300x50,32.73644,8231,7790,3,84,0,84
USD,ttd male sx,240x400,0.012755,2,1,0,0,0,0
USD,/All Apps/Google Play/Health & Fitness,728x90,0.110142,324,322,0,0,0,0
USD,BBB perf arts 5 black sx,300x250,12.65094,1405,1297,1,5,0,5
USD,DO NOT USE Mobile - MoPub - Arts & Entertainment,320x50,45.674355,58571,58047,78,3,2,1
USD,DO NOT USE OAM UK,300x100,0.212041,40,36,0,0,0,0
USD,DO NOT USE fgu test public channel,320x50,240.824565,49827,42696,22,55,3,52
USD,PAC Singapore sx,160x600,0.58797,16,13,0,0,0,0
USD,mogo marks perf arts silver sx,300x250,4492.409654,357437,262375,384,1774,170,1604
